who played kirk?	["Jimmy Bennett", "Chris Pine", "William Shatner"]	["William Shatner", "Chris Pine", "Jimmy Bennett"]
what did romo do?	["Baseball player"]	[]
what does sarabi?	["Physician"]	["Actor", "Teacher", "Model"]
who is rick scott?	["Investor", "Businessperson", "Politician", "Lawyer"]	["Businessperson", "Lawyer", "Politician", "Investor"]
who did lbj marry?	["Lady Bird Johnson"]	["Lady Bird Johnson"]
who was dan white?	["Firefighter", "Politician", "Police officer"]	["Politician", "Police officer", "Firefighter"]
who plays voldemort?	["Richard Bremmer", "Frank Dillane", "Ralph Fiennes", "Hero Fiennes-Tiffin", "Christian Coulson"]	["Ralph Fiennes", "Richard Bremmer", "Frank Dillane", "Christian Coulson", "Hero Fiennes-Tiffin"]
who founded the kkk?	["Albert Pike", "David Duke", "William Joseph Simmons"]	["Albert Pike", "William Joseph Simmons", "David Duke"]
who founded the afl?	["Bud Adams"]	["Lamar Hunt", "Bud Adams"]
who is jimmy savile?	["Presenter"]	["Presenter", "Disc jockey"]
who was kate chopin?	["Writer"]	["Businessperson", "Novelist", "Writer", "Author"]
who owns google 2012?	["Larry Page", "Sergey Brin"]	["Larry Page", "Sergey Brin"]
where is shakira from?	["Colombia"]	["Barranquilla"]
who plays john connor?	["Edward Furlong", "Christian Bale", "Nick Stahl"]	["Nick Stahl", "Christian Bale", "Edward Furlong"]
who is moira in x men?	["Olivia Williams", "Rose Byrne"]	["Elizabeth McGovern"]
who plays simon birch?	["Ian Michael Smith"]	["Ian Michael Smith"]
what was lucille ball?	["Singer", "Model", "Comedian", "Television Producer", "Actor"]	["Actor", "Television Producer", "Singer", "Comedian", "Model"]
what was robert burns?	["Poet", "Writer", "Bard", "Author"]	["Poet", "Writer", "Author", "Bard"]
when was john paul ii?	["10/16/1978"]	["1920-05-18"]
who were mary shelley?	["Author"]	["Editor", "Novelist", "Writer", "Author", "Biographer", "Essayist", "Dramatist", "Travel writer"]
who is thor heyerdahl?	["Film Director", "Scientist", "Cinematographer", "Actor", "Film Producer"]	["Film Producer", "Actor", "Scientist", "Film Director", "Cinematographer"]
who was wesley snipes?	["Film Producer", "Martial artist", "Actor"]	["Businessperson", "Film Producer", "Actor", "Martial artist"]
where is daud ibrahim?	["Maharashtra"]	[]
who plays juni cortez?	["Daryl Sabara"]	["Daryl Sabara"]
who is angelina jolie?	["Actor"]	["Film Producer", "Actor", "Writer", "Screenwriter", "Voice Actor", "Film Director", "Model"]
what did dr. seuss do?	["Writer"]	["Film Producer", "Poet", "Writer", "Screenwriter", "Songwriter", "Cartoonist", "Artist", "Animator"]
who is jacob latimore?	["Singer", "Actor"]	["Actor", "Singer", "Dancer"]
where buddha come from?	["Lumbini"]	["Lumbini"]
what does monsanto own?	["Agricultural Chemicals", "Seed", "Agriculture", "Chemical industry"]	["Monsanto Romania SRL", "Monsanto Philippines Inc", "Monsanto India Ltd.", "Monsanto Argentina SAIC", "Monsanto Agricultura Espana SA", "Monsanto Canada", "American Seeds LLC", "Holdens Foundation Seeds LLC", "Fontanelle Hybrids Inc", "Monsanto Ag Products LLC", "Monsanto do Brasil Ltda", "Monsanto Comercial S.A. de C.V.", "Channel Bio Corp", "Monsanto International SAR.L", "Monsanto Agricoltura Italia S.p.A.", "Monsanto Nordeste SA", "SEMINIS VEGETABLE SEEDS INC", "Monsanto Korea Inc", "Monsanto Holdings Private Ltd", "P4 Production, L.L.C.", "American Seeds, Inc", "De Ruiter Seeds Group BV", "Monsanto Ag Technologies LLC", "Seminis", "Channel Bio LLC", "Agroeste Sementes SA", "Asgrow Seed Co LLC", "Mahyco Monsanto Biotech (I) Pvt. Ltd.", "Monsanto Technology LLC", "Monsanto Gida ve Tarim Ticaret LTDSTI", "Monsanto Australia Ltd", "Monsanto Chile SA", "Monsanto Treasury Services", "Kruger Seed Company", "Monsanto SAS", "Corn States LLC", "Compania Agricola Colombiana Ltda. y SCA", "Monsanto Holland BV", "Monsanto (Malaysia) Sdn Bhd (Malaysia)", "Bretco Holdings (Mauritius) Ltd (Mauritius)", "Monsanto Europe S.A./N.V.", "Dekalb Genetics Corp", "Semillas y Agroproductos Monsanto S.A. de C.V.", "Marmot Holdings SA", "Monsanto Singapore Co. PTE Ltd."]
who plays billy elliot?	["Jamie Bell"]	["Mike Elliott", "Julie Walters", "Gary Lewis", "Jamie Draven", "Stuart Wells", "Joe Renton", "Jamie Bell", "Nicola Blackwell", "Jean Heywood", "Carol McGuigan", "Colin MacLachlan", "Trevor Fox", "Janine Birkett", "Billy Fane", "Charlie Hardwick"]
what did fred durst do?	["Musician"]	["Businessperson", "Actor", "Guitarist", "Musician", "Singer", "Rapper", "Songwriter", "Film Director"]
who voiced darth vader?	["James Earl Jones"]	["James Earl Jones", "Jake Lloyd", "David Prowse", "Sebastian Shaw", "Hayden Christensen", "Matt Lanter", "Robert E. Bean"]
who played cletus hogg?	["Jack Polick"]	["Jack Polick"]
where is jay leno from?	["New Rochelle"]	["New Rochelle"]
who is sir james dyson?	["Designer", "Industrial designer", "Engineer", "Inventor"]	["Designer", "Inventor", "Engineer", "Industrial designer"]
who plays spike spiegel?	["Steven Blum", "Koichi Yamadera"]	["Koichi Yamadera", "Steven Blum"]
who has ray allen dated?	["Shannon Walker Williams"]	["Shannon Walker Williams"]
where are samsung based?	["Seoul"]	["Seoul"]
where was st. lucy born?	["Syracuse"]	["Syracuse"]
who is keyshia cole dad?	["Leon Cole"]	["Leon Cole", "Yvonne Cole", "Francine Lons"]
where was john jay born?	["New York City"]	["New York City"]
what killed john bonham?	["Inhalation of vomit"]	["Inhalation of vomit"]
what was kim richards in?	["The Car", "Escape to Witch Mountain", "Tuff Turf", "Black Snake Moan", "Race to Witch Mountain", "Devil Dog: The Hound of Hell", "No Deposit, No Return", "Return from Witch Mountain", "Meatballs Part II"]	["Presenter", "Actor"]
where did frank baum die?	["Hollywood"]	["Hollywood"]
where was rihanna raised?	["Saint Michael Parish", "Barbados"]	["Saint Michael Parish"]
who is emma stone father?	["Jeff Stone"]	["Krista Stone", "Jeff Stone"]
where does tim cook work?	["Apple Inc."]	["IBM", "Compaq", "Apple Inc.", "Intelligent Electronics"]
where did robin cook die?	["Inverness"]	["Inverness"]
who were wright brothers?	["Orville Wright", "Wilbur Wright"]	["Wilbur Wright", "Orville Wright"]
where is jason mraz from?	["Mechanicsville"]	["Mechanicsville"]
who was esther's husband?	["Susa"]	[]
where is chris rock from?	["Andrews"]	["Andrews"]
what did st augustine do?	["Physician", "Writer", "Philosopher"]	["Writer", "Philosopher", "Physician"]
where is chris paul from?	["United States of America"]	["Lewisville"]
who is sir francis bacon?	["Philosopher"]	["Spy", "Scientist", "Author", "Philosopher", "Statesman"]
where did mary bell live?	["Newcastle upon Tyne"]	["England"]
who was carolus linnaeus?	["Botanist"]	["Scientist", "Botanist", "Physician", "Biologist"]
who did ben stiller date?	["Christine Taylor"]	["Jeanne Tripplehorn", "Janeane Garofalo", "Amanda Peet", "Calista Flockhart"]
where do john lennon die?	["New York City"]	["New York City"]
who's dating claire danes?	["Hugh Dancy"]	["Ben Lee", "Hugh Dancy", "Billy Crudup"]
who is michael j fox wife?	["Tracy Pollan"]	["Tracy Pollan"]
who did paul revere marry?	["Sarah Revere"]	["Apollos Rivoire", "Deborah Hitchborn"]
where did kim jong il die?	["Pyongyang"]	["Pyongyang"]
who is shakira married to?	["Gerard Piqu\u00e9"]	["Antonio de la R\u00faa", "Gerard Piqu\u00e9"]
who is dirk nowitzki wife?	["Jessica Olsson"]	["Jessica Olsson"]
what would ap xin zhao do?	["Male"]	[]
where did madonna grew up?	["Bay City"]	["Bay City"]
who plays knox overstreet?	["Josh Charles"]	["Josh Charles"]
where is electrolux based?	["Stockholm"]	["Stockholm"]
who has played lex luthor?	["Anthony LaPaglia", "Kevin Spacey", "Clancy Brown", "James Marsters", "Gene Hackman"]	["James Marsters", "Kevin Spacey", "Gene Hackman", "Anthony LaPaglia", "Chris Noth", "Clancy Brown", "Powers Boothe"]
where was st peter killed?	["Rome"]	["Rome"]
where did jay moriarty die?	["Maldives"]	["Maldives"]
what does julian lennon do?	["Singer", "Writer", "Guitarist", "Musician", "Actor", "Singer-songwriter", "Record producer"]	["Singer-songwriter", "Actor", "Guitarist", "Musician", "Singer", "Writer", "Record producer"]
what did thomas malthus do?	["Mathematician", "Demographer", "Scientist", "Economist"]	["Scientist", "Economist", "Mathematician", "Demographer"]
where was terry waite born?	["Bollington"]	["Bollington"]
what is rihanna mum called?	["Monica Braithwaite"]	[]
where did thomas paine die?	["New York City"]	["New York City"]
where is byron nelson 2012?	["Roanoke"]	["Waxahachie"]
where is bob marley buried?	["Bob Marley Mausoleum"]	["Bob Marley Mausoleum"]
where is taylor swift from?	["Reading"]	["Reading"]
where obama went to school?	["Occidental College", "Harvard Law School", "Noelani Elementary School", "Punahou School", "State Elementary School Menteng 01", "St. Francis of Assisi Catholic School", "Columbia University"]	["Columbia University", "Occidental College", "Punahou School", "Harvard Law School", "State Elementary School Menteng 01", "Noelani Elementary School", "St. Francis of Assisi Catholic School"]
where does sami yusuf live?	["United Kingdom"]	["Tehran"]
where did alex chilton die?	["New Orleans"]	["New Orleans"]
what company does nike own?	["Converse", "Hurley International"]	["Converse Trading Co B.V.", "Umbro International JV", "Umbro International Holdings Ltd", "Umbro Schweiz Ltd", "NIKE Cortez", "Umbro Asia Sourcing Ltd", "NIKE Australia Holding B.V.", "Umbro Finance Ltd", "NIKE Finance Ltd", "Hurley999 UK Ltd", "NIKE Europe Holding B.V.", "NIKE BH B.V.", "Converse Hong Kong Ltd", "Hurley Australia Pty Ltd", "NIKE South Africa Holdings LLC", "Converse", "NIKE Hong Kong Ltd", "NIKE Waffle", "Twin Dragons Global Ltd", "Nike Skateboarding", "Savier Inc", "NIKE International Ltd", "NIKE IHM Inc", "Cole Haan", "NIKE GmbH", "NIKE de Chile Ltda", "NIKE International Holding Inc", "Hurley International", "NIKE Huarache", "NIKE Finland OY", "NIKE Laser Holding B.V.", "NIKE Vapor Ltd", "NIKE Tailwind", "NIKE Suzhou Holding HK Ltd", "PMG International Ltd", "NIKE do Brasil Comercio e Participacoes Ltda", "NIKE USA Inc", "Nike Golf", "NIKE de Mexico S de R.L. de C.V.", "NIKE Max LLC", "Converse (Asia Pacific) Ltd", "NIKE Global Services PTE. LTD", "PT Hurley Indonesia", "NIKE France SAS.", "NIKE Vietnam Co", "Exeter Hong Kong Ltd", "Umbro Ltd", "NIKE Pegasus", "Umbro Sportwear Ltd", "NIKE Russia LLC", "Futbol Club Barcelona SL", "NIKE NZ Holding B.V.", "Hurley 999 SL", "NIKE Logistics Yugen Kaisha", "NIKE (UK) Ltd", "Umbro.com", "NIKE Holding LLC", "Umbro", "NIKE Hellas EPE", "Converse Canada Holding B.V.", "NIKE Japan Corp", "Umbro International Ltd", "NIKE India Holding B.V.", "Manchester United Merchandising Ltd", "NIKE Vision Timing & Techlab LP", "Converse Footwear Technical Service (Zhongshan) Co Ltd", "NIKE Lavadome", "NIKE CA LLC", "Juventus Merchandising S.r.l.", "NIKE Retail B.V.", "Umbro Licensing Ltd", "Triax Insurance Inc", "NIKE Chile B.V.", "NIKE Retail LLC", "NIKE TN Inc", "NIKE Offshore Holding B.V.", "NIKE Servicios de Mexico S. de R.L. de C.V.", "NIKE Zoom LLC", "BRS NIKE Taiwan Inc", "NIKE Jump Ltd", "USISL Inc", "Nike Vision", "NIKE Licenciamentos do Brasil Ltda", "American NIKE SL", "Converse Sporting Goods (China) Co Ltd", "NIKE Israel Ltd", "NIKE Global Holding B.V.", "NIKE Flight", "Cole Haan Japan", "NIKE New Zealand Co", "Yugen Kaisha Hurley Japan", "PT NIKE Indonesia", "Cole Haan Co Store", "NIKE Argentina Srl", "Converse Netherlands B.V.", "Umbro HK Ltd", "Exeter Brands Group LLC", "NIKE China Holding HK Ltd", "NIKE Trading Co B.V.", "NIKE Canada Holding B.V.", "Twin Dragons Holding B.V.", "NIKE International Holding B.V.", "NIKE International LLC", "NIKE 360 Holding B.V.", "NIKE Retail Services Inc", "NIKE Galaxy Holding B.V.", "NIKE Asia Holding B.V.", "Cole Haan Hong Kong Ltd", "NIKE (Thailand) Ltd", "NIKE Sports Korea Co Ltd", "NIKE India Private Ltd", "NIKE Sourcing India Private Ltd", "NIKE UK Holding B.V.", "NIKE Denmark ApS", "NIKE Australia Pty. Ltd", "Umbro JV Ltd", "NIKE SINGAPORE PTE LTD", "Hurley International Holding B.V.", "NIKE Italy S.R.L.", "NIKE Poland Sp.zo.o", "NIKE (Suzhou) Sports Co Ltd", "NIKE Retail Poland sp. z o. o.", "NIKE Sports (China) Co Ltd", "NIKE Deutschland GmbH", "NIKE (Switzerland) GmbH", "NIKE Dunk Holding B.V.", "Bragano Trading S.r.l.", "NIKE European Operations Netherlands B.V.", "NIKE Philippines Inc", "NIKE Mexico Holdings LLC", "NIKE SALES (MALAYSIA) SDN. BHD.", "NIKE South Africa Ltd", "NIKE Africa Ltd", "NIKE Canada Corp", "Converse Canada Corp", "NIKE Global Trading PTE. LTD", "NIKE Group Holding B.V.", "Converse Hong Kong Holding Co Ltd", "Umbro Worldwide Ltd", "NIKE Sweden AB"]
who is judy garland father?	["Francis Avent Gumm"]	["Ethel Marion Milne", "Francis Avent Gumm"]
who did ben franklin marry?	["Deborah Read"]	["Deborah Read"]
where michael jackson from?	["Gary"]	["Gary"]
when was lucy lawless born?	["New Zealand"]	["1968-03-29"]
who did darth vaders voice?	["James Earl Jones"]	["James Earl Jones", "Jake Lloyd", "David Prowse", "Sebastian Shaw", "Hayden Christensen", "Matt Lanter", "Robert E. Bean"]
where bin laden got killed?	["Abbottabad"]	["Abbottabad"]
where all did picasso live?	["M\u00e1laga", "France"]	["France", "M\u00e1laga"]
what did john dalton study?	["Chemist"]	["Chemist", "Physicist"]
where did adolf hitler die?	["Berlin"]	["Berlin"]
who is tatyana ali parents?	["Sonia Ali", "Sheriff Ali"]	["Sonia Ali", "Sheriff Ali"]
where did melba beals live?	["Arkansas"]	["Arkansas"]
what did bobby darin die of?	["Surgical complications"]	["Surgical complications"]
where is tyrese gibson from?	["Watts"]	["Watts"]
where did tim tebow grow up?	["Manila"]	["United States of America"]
who is michael j fox's wife?	["Tracy Pollan"]	["Tracy Pollan"]
who is john cena married to?	["Elizabeth Huberdeau"]	["Elizabeth Huberdeau"]
where george lopez was born?	["Mission Hills"]	["Mission Hills"]
what was dr seuss real name?	["Theodor Robert Geisel"]	["Geisel Library", "Dr. Seuss Memorial"]
who does darth vaders voice?	["James Earl Jones"]	["James Earl Jones", "Jake Lloyd", "David Prowse", "Sebastian Shaw", "Hayden Christensen", "Matt Lanter", "Robert E. Bean"]
where does dave ramsey live?	["Nashville"]	["Nashville"]
what did bernie mac died of?	["Pneumonia"]	["Pneumonia"]
what school did miley cyrus?	["Heritage Elementary School"]	["Heritage Elementary School"]
what nationality is rihanna?	["Barbados"]	["Barbados"]
which country invented nike?	["United States of America"]	["Phil Knight", "Bill Bowerman"]
what all does google now do?	["Google Maps", "Nexus 7", "Google Buzz", "Nexus 10", "Nexus One", "Nexus S", "Google Chrome", "Google Earth", "Google Wave"]	[]
who did michael j fox marry?	["Tracy Pollan"]	["Tracy Pollan"]
what movies is omar epps in?	["Daybreak", "Major League II", "Scream 2", "First Time Felon", "Breakfast of Champions", "Juice", "The Program", "Deadly Voyage", "Higher Learning", "Don't Be a Menace to South Central While Drinking Your Juice in the Hood"]	["In Too Deep", "Scream 2", "Conviction", "First Time Felon", "Big Trouble", "Deadly Voyage", "Breakfast of Champions", "Higher Learning", "Against the Ropes", "Love & Basketball", "Major League II", "MTV 20: Jams", "Brother", "Perfume", "Alfie", "The Mod Squad", "The Wood", "A Day in the Life", "Don't Be a Menace to South Central While Drinking Your Juice in the Hood", "Daybreak", "The Program", "Juice", "Dracula 2000"]
what was dr seuss education?	["Dartmouth College", "University of Oxford", "Lincoln College, Oxford"]	["Dartmouth College", "University of Oxford", "Lincoln College, Oxford"]
who is robin roberts father?	["Lawrence E. Roberts"]	["Lawrence E. Roberts", "Lucimarian Tolliver"]
where do they speak tibetan?	["Tibet"]	["China", "Tibet"]
where is harvard university?	["Massachusetts"]	["Cambridge"]
what does helen flanagan do?	["Actor"]	["Actor"]
where did the taliban began?	["Afghanistan"]	[]
where did richard nixon die?	["New York City"]	["New York City"]
where was huey newton killed?	["Oakland"]	["Oakland"]
where did djokovic come from?	["Serbia"]	["Serbia"]
who is niall ferguson's wife?	["Ayaan Hirsi Ali"]	["Ayaan Hirsi Ali", "Susan Douglas"]
who is anne hathaway parents?	["Gerald Hathaway", "Kate McCauley Hathaway"]	["Kate McCauley Hathaway", "Gerald Hathaway"]
what does matt damon play in?	["American Teacher", "Contagion", "Che: Part Two", "All the Pretty Horses", "Courage Under Fire", "Dogma", "Behind the Screens", "Confessions of a Dangerous Mind", "Elysium", "Chasing Amy"]	["Glory Daze", "Hereafter", "The Informant!", "Behind the Candelabra", "Liberace", "The Talented Mr. Ripley", "Invictus", "The Departed", "Dogma", "The Majestic", "Magnificent Desolation: Walking on the Moon 3D", "Geronimo: An American Legend", "Spirit: Stallion of the Cimarron", "The Bourne Supremacy", "The Bourne Identity", "Saving Private Ryan", "Jersey Girl", "The Brothers Grimm", "Stuck on You", "Margaret", "Chasing Amy", "The Rainmaker", "True Grit", "Ocean's Twelve", "School Ties", "The Good Shepherd", "Che: Part Two", "We Bought a Zoo", "Field of Dreams", "Saving Private Ryan: Bonus Material", "The People Speak", "Green Zone", "The Legend of Bagger Vance", "Contagion", "Behind the Screens", "Titan A.E.", "Happy Feet Two", "Jay and Silent Bob Strike Back", "Good Will Hunting", "The Bourne Ultimatum", "Elysium", "The Good Mother", "Ocean's Thirteen", "The Zero Theorem", "Courage Under Fire", "Confessions of a Dangerous Mind", "Finding Forrester", "Ocean's Eleven", "The Adjustment Bureau", "Syriana", "Youth Without Youth", "Monuments Men", "EuroTrip", "Rounders", "Inside Job", "All the Pretty Horses", "Mystic Pizza", "The Third Wheel", "The Good Old Boys", "Unauthorized: The Harvey Weinstein Project", "Rising Son", "Gerry", "American Teacher", "Oh, What a Lovely Tea Party", "Promised Land", "Push, Nevada", "Rounders 2"]
who did morgan freeman marry?	["Myrna Colley-Lee"]	["Myrna Colley-Lee", "Jeanette Adair Bradshaw"]
who is willow smith mom name?	["Jada Pinkett Smith"]	["Will Smith", "Jada Pinkett Smith"]
what did vera ellen die from?	["Cancer"]	["Cancer"]
where did john franklin live?	["Blue Island"]	["Spilsby"]
who did annie oakley married?	["Frank E. Butler"]	["Frank E. Butler"]
who did vladimir lenin marry?	["Nadezhda Krupskaya"]	["Nadezhda Krupskaya"]
where did russians originate?	["East Slavs", "Europeans"]	["Europeans", "East Slavs"]
what did dr josef mengele do?	["Physician"]	["Physician"]
who is michael j fox parents?	["Phyllis Piper", "William Fox"]	["William Fox", "Phyllis Piper"]
what did jesus do for living?	["Preacher", "Prophet", "Carpenter"]	["Prophet", "Preacher", "Carpenter"]
what race is vanessa carlton?	["Russian", "Scandinavians"]	["United States of America"]
where did thomas hobbes live?	["Westport, Wiltshire"]	["Paris"]
who did sandra bullock marry?	["Jesse James"]	["Jesse James"]
what did andy irons die from?	["Myocardial infarction"]	["Myocardial infarction"]
what college did brett favre?	["The University of Southern Mississippi"]	["The University of Southern Mississippi"]
where is audrey hepburn from?	["Ixelles"]	["Ixelles"]
what was f. scott fitzgerald?	["Poet", "Novelist", "Writer"]	["Novelist", "Poet", "Writer"]
where did charles darwin die?	["Down House"]	["Down House"]
what does janelle brown work?	["Actor"]	["United States of America"]
what does wh smith stand for?	["William Henry Smith"]	["Swindon"]
who is in paul ryan's family?	["Elizabeth Ryan", "Charles Ryan", "Samuel Ryan"]	["Politician"]
what did miles davis died of?	["Pneumonia", "Stroke", "Respiratory failure"]	["Respiratory failure", "Pneumonia", "Stroke"]
what language do serbs speak?	["Serbian language"]	["Serbian language"]
who is nick lachey married to?	["Vanessa Minnillo"]	["Jessica Simpson", "Vanessa Minnillo"]
what college did se hinton go?	["University of Tulsa"]	["University of Tulsa", "Will Rogers High School"]
what was hitler the leader of?	["Nazi Germany"]	["Catholicism", "Christianity"]
where are boeing headquarters?	["Seattle", "Chicago"]	["Chicago", "Seattle"]
where is harley davidson made?	["United States of America"]	["Milwaukee"]
who did roger federer married?	["Mirka Federer"]	["Mirka Federer"]
who was jesse james killed by?	["The Assassination of Jesse James by the Coward Robert Ford"]	["Saint Joseph"]
where did diego velazquez die?	["Madrid"]	["Madrid"]
who was judi dench married to?	["Michael Williams"]	["Michael Williams"]
where does bradley walsh live?	["England"]	["Los Angeles", "Toronto"]
who is kevin jonas married to?	["Danielle Deleasa"]	["Danielle Deleasa"]
where does tim roth come from?	["England"]	["England", "United Kingdom"]
what country is nike based in?	["United States of America"]	["Beaverton"]
what did randy savage died of?	["Myocardial infarction", "Traffic collision"]	["Myocardial infarction", "Traffic collision"]
who plays edward scissorhands?	["Johnny Depp"]	["Robert Oliveri", "Dianne Wiest", "Kathy Baker", "Caroline Aaron", "Johnny Depp", "Conchata Ferrell", "Vincent Price", "Dick Anthony Williams", "Alan Arkin", "Winona Ryder", "John Davidson", "Anthony Michael Hall", "Biff Yeager", "Susan Blommaert", "O-Lan Jones", "Linda Perri"]
where is the ufc headquarters?	["Las Vegas"]	["Las Vegas"]
what movies did tupac star in?	["Nothing but Trouble"]	[]
what was dr seuss's real name?	["Theodor Robert Geisel"]	["Geisel Library", "Dr. Seuss Memorial"]
where is ibrahim afellay from?	["Utrecht"]	["Utrecht"]
who would play luke skywalker?	["Mark Hamill"]	["Mark Hamill"]
where was elvis costello born?	["Paddington"]	["Paddington"]
where does sherrod brown live?	["Mansfield"]	["Mansfield"]
what did peter tchaikovsky do?	["Composer"]	["Composer", "Writer"]
what did george clemenceau do?	["Newspaper", "Physician", "Statesman", "Publisher"]	["Newspaper", "Physician", "Publisher", "Statesman"]
where was shakespeare born at?	["Stratford-upon-Avon"]	["Stratford-upon-Avon"]
what movies has spike lee made?	["Jungle Fever", "Inside Man", "He Got Game", "Clockers", "Bamboozled", "25th Hour", "Girl 6", "Get on the Bus", "Crooklyn", "Do the Right Thing"]	["25th Hour", "Love & Basketball", "Do the Right Thing", "She's Gotta Have It", "4 Little Girls", "When the Levees Broke"]
who was kobe bryant drafted by?	["Los Angeles Lakers"]	["Lower Merion High School"]
where did leif ericson grow up?	["Iceland"]	["Iceland"]
where president obama was born?	["Honolulu"]	["Honolulu"]
what was john deere famous for?	["Agricultural machinery"]	["Charles Deere", "John Deere"]
what did joan crawford died of?	["Myocardial infarction", "Pancreatic cancer"]	["Myocardial infarction", "Pancreatic cancer"]
what did stephen hawking study?	["Physics"]	["University of Oxford", "St Albans High School for Girls", "Trinity Hall, Cambridge", "St Albans School"]
who was queen elizabeth ii mom?	["Queen Elizabeth The Queen Mother"]	["George VI", "Queen Elizabeth The Queen Mother"]
what did ferdinand magellan do?	["Navigator", "Explorer"]	["Navigator", "Sailor", "Explorer"]
what did mark zuckerberg study?	["Harvard University"]	["Harvard University", "Phillips Exeter Academy", "Ardsley High School", "Mercy College"]
what was jesse owens education?	["Ohio State University"]	["Ohio State University", "East Technical High School"]
where did joseph's family live?	["Canaan"]	["Canaan"]
where is tupac from originally?	["East Harlem"]	["East Harlem"]
where did dolly parton grow up?	["Tennessee"]	["Sevierville"]
what has ashley greene been in?	["Skateland", "New Moon", "Radio Free Albemuth", "A Warrior's Heart", "Eclipse", "Summer's Blood", "King of California", "The Apparition", "Twilight", "The Twilight Saga: Breaking Dawn - Part 1"]	["CBGB", "The Boom Boom Room", "Americana", "Random", "Eclipse", "New Moon", "Shrink", "A Warrior's Heart", "Twilight", "The Apparition", "The Twilight Saga: Breaking Dawn - Part 1", "Butter", "Skateland", "The Twilight Saga: Breaking Dawn - Part 2", "Radio Free Albemuth", "Summer's Blood", "Otis", "LOL: Laughing Out Loud", "King of California"]
what did alice paul accomplish?	["Silent Sentinels", "National Woman's Party"]	["Author"]
who did messi have a baby with?	["Antonella Roccuzzo"]	["Antonella Roccuzzo"]
what cancer did patrick swayze?	["Pancreatic cancer"]	["Pancreatic cancer"]
what state does romney live in?	["Massachusetts"]	["Massachusetts", "Bloomfield Hills"]
what is michael kors real name?	["Karl Anderson"]	["Joan Hamburger", "Karl Anderson"]
where was anne boleyn executed?	["Tower of London"]	["Tower of London"]
where does carlos santana live?	["Jalisco"]	["San Francisco", "Tijuana", "Jalisco"]
where did louis sachar grow up?	["East Meadow"]	["East Meadow"]
what is steve nash nationality?	["Canada"]	["England", "Canada"]
where does kurdish people live?	["Asia"]	["Asia"]
where did edgar allan poe died?	["Baltimore"]	["Baltimore"]
what is jamie spears baby name?	["Bryan Spears"]	["Maddie Briann Aldridge"]
what did shannon hoon die from?	["Drug overdose"]	["Drug overdose"]
who is angelina jolies brother?	["James Haven"]	["James Haven"]
when did william mckinley died?	["9/14/1901"]	["Buffalo"]
who is jamie little engaged to?	["Cody Selman"]	["Cody Selman"]
where is jamarcus russell from?	["Mobile"]	["Mobile"]
what did george orwell died of?	["Tuberculosis"]	["Tuberculosis"]
who did sir francis drake marry?	["Mary Newman", "Elizabeth Sydenham"]	["Mary Newman", "Elizabeth Sydenham"]
what was nikola tesla known for?	["Inventor"]	["Inventor", "Physicist", "Scientist", "Electrical engineer", "Mechanical Engineer", "Futurist"]
who is captain james cook facts?	["Explorer"]	["Sailor", "Explorer"]
who was john f kennedy's family?	["John F. Kennedy, Jr.", "Patrick Bouvier Kennedy", "Arabella Kennedy", "Caroline Kennedy"]	["Writer", "Screenwriter", "Politician", "Author", "Military Officer", "Soldier"]
what did f. scott fitzgerald do?	["Poet", "Novelist", "Writer"]	["Novelist", "Poet", "Writer"]
what did gerald r ford die from?	["Cardiovascular disease"]	["Cardiovascular disease"]
who founded new york university?	["Albert Gallatin", "Mordecai Manuel Noah"]	["Albert Gallatin", "Mordecai Manuel Noah"]
where was farrah fawcett buried?	["Westwood Village Memorial Park Cemetery"]	["Westwood Village Memorial Park Cemetery"]
what language do russians speak?	["Russian Language"]	["Russian Language"]
what is eminem's real full name?	["Marshall Bruce Mathers, Jr."]	["Alaina Mathers", "Hailie Jade Scott", "Whitney Mathers"]
what has charlie hunnam been in?	["Deadfall", "Nicholas Nickleby", "Pacific Rim", "Green Street", "Frankie Go Boom", "The Ledge", "Children of Men", "Abandon", "Cold Mountain", "Whatever Happened to Harold Smith?"]	["Green Street", "Pacific Rim", "Nicholas Nickleby", "Deadfall", "Children of Men", "The Ledge", "Abandon", "Cold Mountain", "Frankie Go Boom", "Whatever Happened to Harold Smith?"]
what is cindy sherman known for?	["Photographer"]	["Photographer", "Film Director", "Artist"]
what school did karl benz go to?	["Karlsruhe Institute of Technology", "University of Karlsruhe"]	["Karlsruhe Institute of Technology", "University of Karlsruhe"]
where did eleanor roosevelt die?	["New York City"]	["Manhattan"]
what did steve mcnair died from?	["Ballistic trauma"]	["Ballistic trauma"]
what jobs did robert burns have?	["Poet", "Writer", "Bard", "Author"]	["Poet", "Writer", "Author", "Bard"]
where did theodor schwann study?	["Humboldt University of Berlin"]	["Humboldt University of Berlin", "University of Bonn", "University of W\u00fcrzburg"]
who are serena williams parents?	["Richard Williams", "Oracene Price"]	["Oracene Price", "Richard Williams"]
where did emperor hirohito live?	["Japan"]	["Japan"]
where did hank marvin come from?	["Newcastle upon Tyne"]	["England"]
where does chef ina garten live?	["Brooklyn"]	["Brooklyn"]
where did kate gosselin grew up?	["Philadelphia"]	["Philadelphia"]
what movies queen latifah is in?	["Taxi", "Jungle Fever", "Set It Off", "Stranger than Fiction", "Last Holiday", "Brown Sugar", "Ice Age: The Meltdown", "Ice Age: Dawn of the Dinosaurs", "Hairspray", "Bringing Down the House"]	["Chicago", "The Cookout", "Stranger than Fiction", "Hairspray", "Bringing Down the House", "Bringing Out the Dead", "The Muppets' Wizard of Oz", "Jungle Fever", "Last Holiday", "The Secret Life of Bees", "Barbershop 2: Back in Business", "The Dilemma", "Ice Age: The Meltdown", "Ice Age: Continental Drift", "The Making of What's Going On: An All-Star Tribute", "Valentine's Day", "Just Wright", "Ice Age: Dawn of the Dinosaurs", "Taxi", "Sphere", "Hoodlum", "The Bone Collector", "Mad Money", "The Perfect Holiday", "What Happens in Vegas", "Brown Sugar", "Joyful Noise", "Ice Age: A Mammoth Christmas", "Scary Movie 3", "Living Out Loud", "Beauty Shop", "The Country Bears", "Living with the Dead", "Kung Faux: Vol. 5", "One Love: The Bob Marley All-Star Tribute", "Life in the 310: Vol. 3", "The Official Inaugural Celebration", "House Party 2", "Kung Faux: Vol. 3", "Kung Faux: Vol. 2", "Life Support", "Steel Magnolias", "Kung Faux: Vol. 4", "My Life", "Breaking Out: The Alcatraz Concert", "Through the Years of Hip-Hop: Vol. 1: Graffiti", "Kung Faux: Vol. 1", "Set It Off", "Juice", "We Are Family", "Zac Efron's Pool Party", "Arctic Tale", "Hairspray 2: White Lipstick", "Queen Latifah: Unauthorized"]
who did kimberly williams marry?	["Brad Paisley"]	["Brad Paisley"]
what did gloria steinem founded?	["Coalition of Labor Union Women", "National Women's Political Caucus", "New York Media Holdings, LLC", "Women's Action Alliance", "Choice USA", "Feminist Majority Foundation", "Ms. Foundation for Women"]	["National Women's Political Caucus", "Coalition of Labor Union Women", "Feminist Majority Foundation", "New York Media Holdings, LLC", "Ms. Foundation for Women", "Choice USA", "Women's Action Alliance"]
what is claire danes famous for?	["Actor"]	["Actor", "Voice Actor"]
who owns volkswagen car company?	["Volkswagen Group"]	["Ferdinand Porsche"]
what drug killed marilyn monroe?	["Barbiturate"]	["Suicide", "Drug overdose", "Barbiturate"]
what makes elvis presley famous?	["Singer"]	["Actor", "Musician", "Singer", "Soldier"]
who was queen isabella's mother?	["Maria of Aragon, Queen of Portugal"]	["Isabella of Portugal, Queen of Castile", "John II of Castile"]
where did antoine lavoisier die?	["Place de la Concorde"]	["Place de la Concorde"]
what did martha graham train as?	["Screenwriter", "Choreographer"]	["Screenwriter", "Choreographer"]
who plays king julian madagascar?	["Sacha Baron Cohen"]	[]
what year did the phillies begin?	["1883"]	["1883"]
what is penn state's main campus?	["University Park"]	["H. Laddie Montague, Jr. Law Library", "Paterno Library", "Pattee Library"]
who is the president of peru now?	["Ollanta Humala"]	["Sim\u00f3n Bol\u00edvar", "Ollanta Humala"]
what does lauren conrad major in?	["Fashion design"]	["Fashion Designer", "Actor", "Author", "TV Personality"]
who were king henry vii children?	["Arthur, Prince of Wales", "Margaret Tudor", "Mary Tudor, Queen of France", "Henry VIII of England", "Edward Tudor", "Katherine Tudor", "Edmund Tudor, Duke of Somerset", "Elizabeth Tudor"]	["Arthur, Prince of Wales", "Edward Tudor", "Henry VIII of England", "Katherine Tudor", "Elizabeth Tudor", "Edmund Tudor, Duke of Somerset", "Mary Tudor, Queen of France", "Margaret Tudor"]
what did pamela courson die from?	["Heroin overdose", "Drug overdose"]	["Drug overdose", "Heroin overdose"]
who was queen victoria's husband?	["Albert, Prince Consort"]	["Albert, Prince Consort"]
what country is nicki minaj from?	["Trinidad and Tobago"]	["United States of America", "Trinidad and Tobago"]
what did elvis presley died from?	["Myocardial infarction"]	["Myocardial infarction"]
where did crabtree go to college?	["Texas Tech University"]	[]
where laura ingalls wilder lived?	["South Dakota", "Wisconsin"]	["Wisconsin", "South Dakota"]
what city does paul ryan live in?	["Janesville"]	["Janesville"]
what was robert burns famous for?	["Poet"]	["Poet", "Writer", "Author", "Bard"]
what does kim kardashian work as?	["Entrepreneur", "Model", "Businessperson", "Actor"]	["ShoeDazzle", "D-A-S-H"]
where was mary todd lincoln from?	["Lexington", "Springfield"]	["Lexington"]
who was the son of king leonidas?	["Pleistarchus"]	["Pleistarchus"]
where did benjamin franklin work?	["James Franklin Printing Shop", "United States Postal Service", "Josiah Franklin"]	["Josiah Franklin", "United States Postal Service", "James Franklin Printing Shop"]
what was jesse james killed with?	["Assassination", "Firearm"]	["Assassination", "Firearm"]
who is dustin johnson the golfer?	["Golfer"]	["Amanda Caulder"]
who is amy grant's first husband?	["Vince Gill"]	["Vince Gill", "Gary Chapman"]
who was richard nixon married to?	["Pat Nixon"]	["Pat Nixon"]
who did the voice for lola bunny?	["Britt McKillip", "Kath Soucie"]	["Britt McKillip", "Kath Soucie"]
where was osama bin laden killed?	["Abbottabad"]	["Abbottabad"]
when was father chris riley born?	["1967"]	["Echuca"]
where did mubarak get his wealth?	["Politician"]	["Al Minufiyah"]
what religion was king louis xiv?	["Catholicism"]	["Catholicism"]
who did denise van outen married?	["Lee Mead"]	["Lee Mead"]
who did william shakespeare marry?	["Anne Hathaway"]	["Anne Hathaway"]
where does lil wayne go to school?	["University of Houston"]	["University of Houston", "Lafayette Elementary School", "University of Phoenix", "Eleanor McMain Secondary School", "Mcmain Magnet Secondary School"]
who is princess leia in star wars?	["Carrie Fisher"]	["Carrie Fisher"]
who did james franco play in milk?	["Him/Herself"]	["Scott Smith"]
what did warren buffett invest in?	["Berkshire Hathaway"]	["Businessperson", "Entrepreneur", "Financier", "Investor"]
where was rihanna born and raised?	["Saint Michael Parish", "Barbados"]	["Saint Michael Parish"]
where is president kennedy buried?	["Arlington National Cemetery"]	["Arlington National Cemetery"]
who was juan ponce de leon family?	["Leonor de Guzm\u00e1n de Silva", "Juan Ponce de Le\u00f3n, II conde de Arcos"]	["Explorer"]
what college did maya moore go to?	["University of Connecticut"]	["University of Connecticut", "Collins Hill High School"]
where is dwayne johnson ethnicity?	["African American", "Samoan American"]	["Hayward"]
who is khloe kardashian's husband?	["Lamar Odom"]	["Lamar Odom"]
where did anne frank go to school?	["Montessori Lyceum Amsterdam"]	["Montessori Lyceum Amsterdam", "Jewish Lyceum"]
what nationality is mother teresa?	["India"]	["India", "Albania"]
where did giuliana rancic grow up?	["Naples"]	["Washington, D.C."]
who did vasco de gama explore for?	["Portugal"]	["Kochi"]
what state did john adams live in?	["Massachusetts"]	["Massachusetts", "Braintree"]
what was scottie pippen known for?	["Basketball player"]	["Actor", "Basketball player"]
who is angelina jolie mom and dad?	["Jon Voight", "Marcheline Bertrand"]	["Jon Voight", "Marcheline Bertrand"]
where did salvador dali study art?	["Real Academia de Bellas Artes de San Fernando"]	["Real Academia de Bellas Artes de San Fernando"]
where did morgan freeman graduate?	["Jackson State University", "Los Angeles City College"]	["Jackson State University", "Los Angeles City College"]
who was king george vi married to?	["Queen Elizabeth The Queen Mother"]	["Queen Elizabeth The Queen Mother"]
who played dana scully in x files?	["Gillian Anderson"]	["Gillian Anderson"]
where did paula deen go to school?	["Albany High School"]	["Albany High School"]
what language do the maasai speak?	["Maasai Language"]	["Kenya", "Tanzania"]
where was teddy roosevelt's house?	["New York City"]	["Manhattan"]
what has kristen stewart acted in?	["New Moon", "Eclipse", "The Runaways", "Snow White and the Huntsman", "Twilight", "The Twilight Saga: Breaking Dawn - Part 1"]	["Into the Wild", "The Messengers", "Panic Room", "Eclipse", "What Just Happened", "New Moon", "On the Road", "Catch That Kid", "The Flintstones in Viva Rock Vegas", "Snow White and the Huntsman", "Twilight", "Jumper", "Zathura", "Cold Creek Manor", "In the Land of Women", "Adventureland", "The Twilight Saga: Breaking Dawn - Part 1", "The Yellow Handkerchief", "Fierce People", "The Runaways", "The Twilight Saga: Breaking Dawn - Part 2", "The Safety of Objects", "Speak", "The Cake Eaters", "Welcome to the Rileys", "The Thirteenth Year", "The Big Shoe", "Cutlass", "Undertow", "Camp X-Ray", "Snow White and the Huntsman 2", "Sils Maria"]
who does the voice for darth vader?	["James Earl Jones"]	["James Earl Jones", "Jake Lloyd", "David Prowse", "Sebastian Shaw", "Hayden Christensen", "Matt Lanter", "Robert E. Bean"]
what is carlos pena jr nationality?	["Dominican Republic"]	["United States of America"]
who was ptolemy and what did he do?	["Mathematician", "Astronomer", "Astrologer", "Geographer", "Philosopher"]	["Astrologer", "Mathematician", "Astronomer", "Philosopher", "Geographer"]
what does barbara bush do for work?	["First Lady"]	["Federal government of the United States"]
where did the anasazi indians live?	["Four Corners"]	["Four Corners"]
where does fabio capello come from?	["Italy"]	["Italy"]
what school did wilfred owen go to?	["University of London", "University of Reading"]	["University of London", "University of Reading"]
where did venus williams come from?	["Lynwood"]	["United States of America"]
what disease did bernie mac die of?	["Pneumonia"]	["Pneumonia"]
what happened to pope john paul ii?	["Myocardial infarction", "Parkinson's disease"]	["Parkinson's disease", "Myocardial infarction"]
who did granville t. woods married?	["Loretta Woods"]	["Loretta Woods"]
what has shannen doherty played in?	["Girls Just Want to Have Fun", "A Burning Passion: The Margaret Mitchell Story", "Category 7: The End of the World", "Freeze Frame", "Christmas Caper", "Burning Palms", "Another Day", "Blindfold: Acts of Obsession", "Almost Dead", "Friends 'Til the End"]	["The Secret of NIMH", "Gone in the Night", "Another Day", "Gretl", "Growing the Big One", "Witchslayer Gretl", "Nowhere", "Christmas Caper", "Girls Just Want to Have Fun", "Nightlight", "Obsessed", "Blindfold: Acts of Obsession", "Jay and Silent Bob Strike Back", "A Burning Passion: The Margaret Mitchell Story", "Mallrats", "Burning Palms", "Satan's School for Girls", "Heathers", "Hell on Heels: The Battle of Mary Kay", "Almost Dead", "Striking Poses", "The Rendering", "The Lost Treasure of the Grand Canyon", "Freeze Frame", "The Other Lover", "Night Shift", "Category 7: The End of the World", "The Delphi Effect", "The Ticket", "Jailbreakers", "Friends 'Til the End", "Sleeping with the Devil"]
where did kim kardashian come from?	["Los Angeles"]	["Los Angeles"]
what was shakespeare's wife called?	["Anne Hathaway"]	["John Shakespeare", "Mary Shakespeare"]
where did otto frank go to college?	["Heidelberg College"]	["Heidelberg College"]
who did marilyn monroe marry at 16?	["James Dougherty"]	["Arthur Miller", "James Dougherty", "Joe DiMaggio"]
where did kevin love go to college?	["University of California, Los Angeles"]	["University of California, Los Angeles", "Lake Oswego High School"]
what city did marco polo came from?	["Venice"]	["Venice"]
what college did jrr tolkien go to?	["Exeter College, Oxford"]	["University of Oxford", "Exeter College, Oxford", "King Edward's School, Birmingham", "St. Philip's School"]
where did romney graduated college?	["Stanford University", "Cranbrook Schools", "Harvard Law School", "Harvard Business School", "Harvard University", "Brigham Young University"]	["Harvard University", "Stanford University", "Brigham Young University", "Harvard Business School", "Harvard Law School", "Cranbrook Schools"]
what characters does matt stone do?	["Kyle / Kenny / Jesus"]	["Hermaphrodite", "Kyle / Kenny / Jesus", "Kenny McCormick", "Kyle Broflovski", "The Wizard", "Doug Remer", "James Humphries", "Jimbo Kearn", "Ethan Hawke", "Terrance Henry Stoot", "Ticket Taker", "Gerald Broflovski", "Taper Guy", "Former Columbine Student", "Saddam Hussein", "Dave the Lighting Guy", "Danny Glover", "Bill Gates", "Chris", "George Clooney", "Man toasting drinks at MCA outdoor bar"]
where did dutch language come from?	["Europeans"]	[]
where did jrr tolkien go to school?	["Exeter College, Oxford", "University of Oxford"]	["University of Oxford", "Exeter College, Oxford", "King Edward's School, Birmingham", "St. Philip's School"]
where is mitt romney's family from?	["Detroit"]	["Detroit"]
where did john mayer go to college?	["Berklee College of Music"]	["Berklee College of Music", "Brien McMahon High School", "Fairfield Warde High School", "Andrew Warde High School"]
where does robert irvine come from?	["Salisbury"]	["United Kingdom", "United States of America"]
what is st anthony patron saint of?	["Padua"]	["Nicomedia"]
what did nicolas cage name his son?	["Kal-El Coppola Cage", "Weston Coppola Cage"]	["Weston Coppola Cage", "Kal-El Coppola Cage"]
where did mario lopez go to school?	["Chula Vista High School"]	["Chula Vista High School"]
what is charlie chaplin famous for?	["Comedian"]	["Composer", "Film Producer", "Actor", "Film Score Composer", "Screenwriter", "Comedian", "Film Editor", "Film Director"]
who played jacob black in twilight?	["Taylor Lautner"]	["Taylor Lautner"]
who originally voiced lois griffin?	["Alex Borstein"]	["Alex Borstein"]
what movies has john williams score?	["A.I. Artificial Intelligence", "Always", "Catch Me If You Can", "1941", "Daddy-O", "Amistad", "Close Encounters of the Third Kind", "E.T. the Extra-Terrestrial", "Empire of the Sun", "Earthquake"]	["Broadway's Best at Pops"]
what is jamie oliver children names?	["Petal Blossom Rainbow Oliver", "Poppy Honey Rosie Oliver", "Daisy Boo Pamela Oliver", "Buddy Bear Maurice Oliver"]	["Petal Blossom Rainbow Oliver", "Daisy Boo Pamela Oliver", "Poppy Honey Rosie Oliver", "Buddy Bear Maurice Oliver"]
what movies has miley cyrus been in?	["Hannah Montana: The Movie", "Super Rhino", "Sonic the Hedgehog", "LOL: Laughing Out Loud", "Big Fish", "Sex and the City 2", "Bolt", "The Last Song", "So Undercover", "High School Musical 2"]	["Family Bond", "Sex and the City 2", "Bolt", "Big Fish", "Rock Mafia Presents: The Big Bang", "Sonic the Hedgehog", "The Last Song", "High School Musical 2", "Hannah Montana: The Movie", "Hannah Montana & Miley Cyrus: Best of Both Worlds Concert", "Super Rhino", "So Undercover", "LOL: Laughing Out Loud", "Radio Disney Party Jams: The Concert", "The World According to Miley Cyrus"]
what did hitler use to kill himself?	["Gunshot", "Suicide"]	["Suicide", "Gunshot"]
what country did magellan represent?	["Portugal"]	["Portugal", "Kingdom of Portugal"]
what school does james franco go to?	["Yale University"]	["Brooklyn College", "Rhode Island School of Design", "Yale University", "University of California, Los Angeles", "Tisch School of the Arts", "Columbia University School of the Arts", "Warren Wilson College", "Palo Alto High School"]
who was jessica simpson married too?	["Nick Lachey"]	["Nick Lachey"]
who plays captain kirk in star trek?	["William Shatner"]	["William Shatner", "Chris Pine", "Jimmy Bennett"]
where does kate middleton live 2012?	["Reading"]	["Reading", "Bucklebury"]
where was marilyn monroe found dead?	["Brentwood"]	["Brentwood"]
where was theodore roosevelt buried?	["Youngs Memorial Cemetery"]	["Youngs Memorial Cemetery"]
what movies did nick cannon star in?	["A Very School Gyrls Holla-Day", "Bobby", "Day of the Dead", "Even Money", "Goal II: Living the Dream", "American Son", "Weapons", "Ball Don't Lie", "The Killing Room", "Monster House"]	["Men in Black II", "Whatever It Takes", "Monster House", "Garfield: The Movie", "American Son", "Ball Don't Lie", "Even Money", "Day of the Dead", "Shall We Dance?", "Goal II: Living the Dream", "Bobby", "The Killing Room", "Weapons", "Roll Bounce", "Love Don't Cost a Thing", "School Gyrls", "The Adventures of Brer Rabbit", "Underclassman", "Drumline", "A Very School Gyrls Holla-Day"]
what did joe biden study in college?	["Political Science", "History"]	["Syracuse University", "University of Delaware", "Archmere Academy"]
who did tom hanks play in apollo 13?	["Jim Lovell"]	["Jim Lovell"]
what college did john nash teach at?	["Princeton University"]	["Massachusetts Institute of Technology", "Princeton University"]
what language do the cheyenne speak?	["Cheyenne Language", "English Language"]	["English Language", "Cheyenne Language"]
what is michael kors best known for?	["Fashion Designer"]	["Designer", "Fashion Designer"]
where did alexander graham bell die?	["Beinn Bhreagh, Nova Scotia"]	["Beinn Bhreagh, Nova Scotia"]
where did sanjay gupta go to school?	["University of Michigan", "University of Michigan Health System", "Novi High School"]	["University of Michigan", "University of Michigan Health System", "Novi High School"]
what highschool did r. kelly attend?	["Kenwood Academy"]	["Kenwood Academy"]
what was augustus caesar famous for?	["Roman emperor", "Politician"]	["Politician", "Roman emperor"]
where did kevin james go to college?	["SUNY College at Cortland"]	["SUNY College at Cortland", "Ward Melville High School"]
who was william mckinley married to?	["Ida Saxton McKinley"]	["Ida Saxton McKinley"]
what movies did ron howard director?	["How the Grinch Stole Christmas!"]	["Bitter Harvest", "The Journey", "The First Nudie Musical", "The Independent", "The Courtship of Eddie's Father", "A Beautiful Mind", "How the Grinch Stole Christmas!", "Grand Theft Auto", "Eat My Dust!", "More American Graffiti", "The Spikes Gang", "The Shootist", "Osmosis Jones", "American Graffiti", "Fire on the Mountain", "The Wild Country", "Act of Love", "Five Minutes to Live", "Return to Mayberry", "The Music Man", "Village of the Giants", "Welcome to Hollywood", "I'm a Fool", "Night Shift", "When Your Lover Leaves", "Huckleberry Finn", "Cannes: All Access"]
where did joe flacco attend college?	["University of Delaware"]	["University of Delaware"]
what films has daniel craig been in?	["The Invasion", "Casino Royale", "Munich", "Enduring Love", "Layer Cake", "A Kid in King Arthur's Court", "The Jacket", "The Mother", "Sylvia", "Road to Perdition"]	["The Golden Compass", "Love is the Devil: Study for a Portrait of Francis Bacon", "Elizabeth", "Lara Croft: Tomb Raider", "Road to Perdition", "Munich", "Infamous", "Hotel Splendide", "Copenhagen", "A Kid in King Arthur's Court", "The Organ Grinder's Monkey", "The Girl Who Played with Fire", "Quantum of Solace", "Cowboys & Aliens", "The Invasion", "The Adventures of Tintin: The Secret of the Unicorn", "Casino Royale", "Enduring Love", "The Jacket", "Dream House", "The Girl with the Dragon Tattoo", "Flashbacks of a Fool", "Sylvia", "Skyfall", "Defiance", "Fateless", "Obsession", "Some Voices", "The Trench", "Sharpe's Eagle", "I Dreamed of Africa", "Layer Cake", "Archangel", "Kiss and Tell", "The Adventures of Young Indiana Jones: Daredevils of the Desert", "Sword of Honour", "The Power of One", "Saint-Ex", "Love and Rage", "Renaissance", "The Mother", "Bond 24", "James Bond Supports International Women's Day", "Bond 25"]
where did richard arkwright grow up?	["England"]	["Preston"]
what is newt gingrich's wife's name?	["Callista Gingrich"]	["Kathleen Daughterty", "Newton McPherson", "Robert Gingrich"]
what religion does madonna practice?	["Catholicism", "Jewish Renewal"]	["Jewish Renewal", "Catholicism"]
where does robin williams live 2011?	["San Francisco"]	["San Francisco", "Bloomfield Hills"]
where are kohler sinks manufactured?	["Kohler"]	["Skierbiesz\u00f3w"]
what was the name of jfk's brothers?	["Robert F. Kennedy", "Ted Kennedy", "Rosemary Kennedy", "Kathleen Cavendish", "Patricia Kennedy Lawford", "Jean Kennedy Smith", "Eunice Kennedy Shriver", "Joseph P. Kennedy, Jr."]	["Jean Kennedy Smith", "Ted Kennedy", "Eunice Kennedy Shriver", "Kathleen Cavendish", "Joseph P. Kennedy, Jr.", "Robert F. Kennedy", "Patricia Kennedy Lawford", "Rosemary Kennedy"]
where was benjamin franklin educated?	["Boston Latin School"]	["Boston Latin School"]
what movies does matt dallas play in?	["The Story of Bonnie and Clyde", "Babysitter Wanted", "Hot Dudes with Kittens", "Beauty & the Briefcase", "In Between Days", "The Indian", "As Good as Dead", "Living the Dream", "Camp Slaughter", "Wyatt Earp's Revenge"]	["The Story of Bonnie and Clyde", "As Good as Dead", "The Ghost of Goodnight Lane", "Living the Dream", "Wannabe", "Way of the Vampire", "Camp Slaughter", "Beauty & the Briefcase", "Wyatt Earp's Revenge", "In Between Days", "Hot Dudes with Kittens", "Babysitter Wanted", "The Indian", "You, Me & The Circus", "In Between Days"]
what colleges did mitt romney attend?	["Stanford University", "Cranbrook Schools", "Harvard Law School", "Harvard Business School", "Harvard University", "Brigham Young University"]	["Harvard University", "Stanford University", "Brigham Young University", "Harvard Business School", "Harvard Law School", "Cranbrook Schools"]
what country was stalin in charge of?	["Soviet Union"]	["Soviet Union"]
where did the yoruba originated from?	["African people"]	["African people"]
what kind of products does nike sell?	["Athletic Shoes & Apparel"]	["Nike Air Max", "Nike Considered"]
who is ryan reynolds married to 2012?	["Blake Lively"]	["Blake Lively", "Scarlett Johansson"]
where did vince scully go to college?	["Fordham University"]	["Fordham University", "Fordham Preparatory School"]
who does michael keaton play in cars?	["Chick Hicks"]	["Chick Hicks"]
who played carmen cortez in spy kids?	["Alexa Vega"]	["Alexa Vega"]
what did the blackfoot indians speak?	["English Language", "Blackfoot Language"]	["English Language", "Blackfoot Language"]
what did jack london do for a living?	["Author", "Sailor", "Journalist", "Novelist", "Screenwriter", "Essayist"]	["Novelist", "Journalist", "Screenwriter", "Author", "Sailor", "Essayist"]
where was bin laden found and killed?	["Abbottabad"]	["Abbottabad"]
who was the father of king george vi?	["George V"]	["George V", "Mary of Teck"]
where was caesar when he was stabbed?	["Theatre of Pompey"]	["Theatre of Pompey"]
where did derek fisher go to college?	["University of Arkansas at Little Rock"]	["University of Arkansas", "University of Arkansas at Little Rock", "Parkview Arts and Science Magnet High School"]
what did st. nicholas do in his life?	["Bishop"]	["Bishop"]
where did robin williams get married?	["St. Helena"]	["Valerie Velardi", "Marsha Garces", "Susan Schneider"]
where did clay matthews go to school?	["Agoura High School", "University of Southern California"]	["University of Southern California", "Agoura High School"]
where did spencer pratt go to school?	["University of Southern California"]	["University of Southern California"]
what did galileo do to become famous?	["Astronomer"]	["Physicist", "Scientist", "Astrologer", "Mathematician", "Astronomer"]
what is president nixon's first name?	["Richard"]	["Tricia Nixon Cox", "Julie Nixon Eisenhower"]
what college did john stockton go to?	["Gonzaga University"]	["Gonzaga University", "Gonzaga Preparatory School"]
who plays eowyn in lord of the rings?	["Miranda Otto"]	["Miranda Otto"]
where did bristol palin go to school?	["Wasilla High School", "West Anchorage High School", "Juneau-Douglas High School"]	["University of Idaho", "Matanuska\u2013Susitna College", "University of Hawaii at Hilo", "Hawaii Pacific University", "Wasilla High School", "North Idaho College"]
what movies does nick cannon play in?	["A Very School Gyrls Holla-Day", "Bobby", "Day of the Dead", "Even Money", "Goal II: Living the Dream", "American Son", "Weapons", "Ball Don't Lie", "The Killing Room", "Monster House"]	["Men in Black II", "Whatever It Takes", "Monster House", "Garfield: The Movie", "American Son", "Ball Don't Lie", "Even Money", "Day of the Dead", "Shall We Dance?", "Goal II: Living the Dream", "Bobby", "The Killing Room", "Weapons", "Roll Bounce", "Love Don't Cost a Thing", "School Gyrls", "The Adventures of Brer Rabbit", "Underclassman", "Drumline", "A Very School Gyrls Holla-Day"]
what language do navajo people speak?	["Spanish Language", "Navajo Language", "English Language"]	["English Language", "Spanish Language", "Navajo Language"]
where was toussaint l'ouverture born?	["Haiti"]	["Haiti"]
what is ella fitzgerald parents name?	["William Fitzgerald", "Temperance Tempie Fitzgerald"]	["Ray Brown, Jr."]
where did jovan belcher kill himself?	["Kansas City"]	["Kansas City"]
which country did nike originate from?	["United States of America"]	["United States of America"]
what industry does walmart operate in?	["Department Stores", "Retail", "Variety Stores"]	["Variety Stores", "Retail", "Department Stores"]
what religion did adolf hitler follow?	["Catholicism", "Christianity"]	["Catholicism", "Christianity"]
where did george michael go to school?	["Bushey Meads School"]	["Bushey Meads School"]
when was herbert hoover born and died?	["8/10/1874"]	["1874-08-10"]
who played bilbo in lord of the rings?	["Norman Bird", "Martin Freeman", "Ian Holm"]	["Martin Freeman", "Ian Holm", "Norman Bird"]
what school did michael jordan attend?	["University of North Carolina at Chapel Hill", "Emsley A. Laney High School"]	["University of North Carolina at Chapel Hill"]
what movies does logan lerman play in?	["The Only Living Boy in New York", "Stuck in Love", "The Perks of Being a Wallflower", "The Three Musketeers", "The Butterfly Effect", "The Number 23", "The Patriot", "The Scribe", "Riding in Cars with Boys", "What Women Want"]	["The Flannerys", "The Only Living Boy in New York", "The Scribe", "Riding in Cars with Boys", "Percy Jackson & the Olympians: The Lightning Thief", "My One and Only", "What Women Want", "Hoot", "Noah", "Gamer", "The Butterfly Effect", "The Number 23", "The Three Musketeers", "Percy Jackson: Sea of Monsters", "Stuck in Love", "The Perks of Being a Wallflower", "3:10 to Yuma", "Meet Bill", "The Patriot", "A Painted House", "Fury"]
where did harry s truman go to school?	["University of Missouri\u2013Kansas City School of Law", "University of Missouri\u2013Kansas City", "William Chrisman High School"]	["William Chrisman High School", "University of Missouri\u2013Kansas City", "University of Missouri\u2013Kansas City School of Law"]
what kind of hispanic is selena gomez?	["Mexicans"]	["Danny Jones Middle School"]
what is colorado technical university?	["Career Education Corporation"]	[]
where were the seneca indians located?	["New York"]	["New York", "Ontario"]
where does michelle pfeiffer live now?	["Orange County"]	["Orange County"]
what cancer did jackie kennedy die of?	["Lymphoma"]	["Cancer", "Lymphoma"]
what did coretta scott king died from?	["Respiratory failure"]	["Respiratory failure"]
what city was michael jackson born in?	["Gary"]	["Gary"]
where is the nra headquarters located?	["Fairfax"]	["Fairfax"]
what movies gerard butler has been in?	["Attila", "Beowulf & Grendel", "300", "Dear Frankie", "Butterfly on a Wheel", "Gamer", "Fast Food", "Dracula 2000", "Coriolanus"]	["The Phantom of the Opera", "Wrath of Gods", "Olympus Has Fallen", "The Cherry Orchard", "Attila", "Chasing Mavericks", "Law Abiding Citizen", "Nim's Island", "Timeline", "How to Train Your Dragon", "The Game of Their Lives", "Tales of the Black Freighter", "Butterfly on a Wheel", "Beowulf & Grendel", "Gift of the Night Fury", "Mrs. Brown", "Gamer", "The Ugly Truth", "Machine Gun Preacher", "Tomorrow Never Dies", "300", "Lara Croft Tomb Raider: The Cradle of Life", "PS, I Love You", "Coriolanus", "Shooters", "Playing for Keeps", "Movie 43", "Harrison's Flowers", "The Bounty Hunter", "RocknRolla", "Reign of Fire", "Thunder Run", "Dear Frankie", "One More Kiss", "Legend of the Boneknapper Dragon", "How to Train Your Dragon 2", "Fast Food", "Dracula 2000", "Jewel of the Sahara", "Dynamo"]
where did rob kardashian go to school?	["University of Southern California", "Marshall School of Business"]	["University of Southern California", "Marshall School of Business"]
what are john terry's children called?	["Georgie John Terry", "Summer Rose Terry"]	["Ted Terry", "Sue Terry"]
where did francisco coronado come from?	["Salamanca"]	["Salamanca"]
what movies has carmen electra been in?	["The Mating Habits of the Earthbound Human", "Scary Movie", "Getting Played", "Cheaper by the Dozen 2", "Meet the Spartans", "I Want Candy", "Full of It", "The Chosen One: Legend of the Raven", "Scary Movie 4", "Dirty Love"]	["Epic Movie", "Disaster Movie", "Starsky & Hutch", "Meet the Spartans", "Scary Movie 4", "Dirty Love", "Date Movie"]
who does amy stiller play in dodgeball?	["Keno Waitress"]	["Kristen", "Parole Board Member Julie", "Cleopatra", "Jolene Lane", "Doctor", "Doctor", "Hansel's Posse Member", "Sylvia Abramson", "Middle-Aged Woman", "Amy Corinne Fairbright-Lebow", "Checkout Girl", "Director", "Pam Bailey", "Keno Waitress", "Steven's Secretary", "Estelle", "Marcy", "Flower Girl/Carol", "Kristen", "Phyllis", "Vegas Divorcee", "Psychic Phone Partner", "Dr. Rosaria Mclesh", "Theater Girl", "Script supervisor", "Cherri Contrary"]
where did william morris go to college?	["Marlborough College", "Exeter College, Oxford", "University of Oxford"]	["Marlborough College", "University of Oxford", "Exeter College, Oxford"]
what country was king tut's tomb found?	["Ancient Egypt"]	["Egypt"]
what did general robert e lee die from?	["Pneumonia"]	["Pneumonia"]
who played amy squirrel in bad teacher?	["Lucy Punch"]	["Lucy Punch"]
where is the seat of the african union?	["Addis Ababa"]	["Addis Ababa"]
where did john steinbeck go to college?	["Stanford University"]	["Stanford University", "Salinas High School"]
what highschool did emily osment go to?	["Flintridge Preparatory School"]	["Flintridge Preparatory School"]
what is berkshire hathaway invested in?	["MOODY'S CORP Common Stock", "BURLINGTON NORTHERN SANTA FE Common Stock"]	["Oliver Chace"]
who killed martin luther king jr video?	["Assassination by firearm"]	["Assassination by firearm"]
which country was michael jackson born?	["United States of America"]	["Gary"]
what school did mark zuckerberg attend?	["Mercy College", "Phillips Exeter Academy", "Harvard University", "Ardsley High School"]	["Harvard University", "Phillips Exeter Academy", "Ardsley High School", "Mercy College"]
what language do bosnian muslims speak?	["Bosnian language"]	["Bosnian language"]
what town did justin bieber grew up in?	["London"]	["London"]
who does mila kunis play on family guy?	["Meg Griffin"]	["Meg Griffin"]
what new movies is robert pattinson in?	["Eclipse", "Dark Kingdom: The Dragon King", "New Moon", "Remember Me", "How to Be", "Harry Potter and the Order of the Phoenix", "Little Ashes", "Bel Ami", "Twilight", "The Twilight Saga: Breaking Dawn - Part 1"]	["The Rover", "Queen of the Desert", "Harry Potter and the Order of the Phoenix", "Eclipse", "Cosmopolis", "New Moon", "Dark Kingdom: The Dragon King", "Mission: Blacklist", "Harry Potter and the Goblet of Fire", "Twilight", "Little Ashes", "Bel Ami", "Vanity Fair", "Water for Elephants", "Remember Me", "The Twilight Saga: Breaking Dawn - Part 1", "The Twilight Saga: Breaking Dawn - Part 2", "Love & Distrust", "The Bad Mother's Handbook", "Unbound Captives", "The Summer House", "How to Be", "The Haunted Airman", "Maps to the Stars", "Hold on to Me"]
where does freddie ljungberg come from?	["Sweden"]	["Sweden"]
what school did robert f kennedy go to?	["Bates College", "Milton Academy", "University of Virginia School of Law", "University of Virginia", "Harvard University", "Harvard College"]	["Harvard College", "Harvard University", "University of Virginia", "Milton Academy", "University of Virginia School of Law", "Bates College"]
what movies did morgan freeman star in?	["10 Items or Less", "Batman Begins", "All About Us", "A Raisin in the Sun", "Bruce Almighty", "Amistad", "Brubaker", "An Unfinished Life", "A Man Called Adam", "Along Came a Spider"]	["The Civil War", "Robin Hood: Prince of Thieves", "War of the Worlds", "Along Came a Spider", "Nurse Betty", "Red", "Olympus Has Fallen", "Clinton and Nadine", "Clean and Sober", "Fight for Life", "Soul Brothas and Sistas: Vol. 4: Quadruple Feature", "We the People", "National Geographic: Inside the White House", "Hard Rain", "Invictus", "Seven", "Magnificent Desolation: Walking on the Moon 3D", "Bruce Almighty", "Levity", "An Unfinished Life", "The Sum of All Fears", "Batman Begins", "The Love Guru", "Guilty by Association", "Moll Flanders", "The Shawshank Redemption", "The Execution of Raymond Graham", "The Dark Knight Rises", "Lucky Number Slevin", "The Dark Knight", "Street Smart", "Evan Almighty", "The Bucket List", "Harry & Son", "Chain Reaction", "The Bonfire of the Vanities", "Resting Place", "A Man Called Adam", "Roll Of Thunder, Hear My Cry", "Amistad", "The Big Bounce", "Million Dollar Baby", "Gone Baby Gone", "Glory", "High Crimes", "Unforgiven", "Conan the Barbarian", "Oblivion", "Driving Miss Daisy", "Kiss the Girls", "For Love of Liberty: The Story of America's Black Patriots", "Dolphin Tale", "Thick as Thieves", "Lean on Me", "Dreamcatcher", "The Contract", "Deep Impact", "Wanted", "Feast of Love", "Now You See Me", "March of the Penguins", "The Long Way Home", "The Maiden Heist", "Johnny Handsome", "The Pawnbroker", "Unleashed", "10 Items or Less", "Outbreak", "Brubaker", "Where Were You When the Lights Went Out?", "The Hunting of the President", "Edison", "That Was Then... This Is Now", "Marie", "Under Suspicion", "Lego: The Piece of Resistance", "The Power of One", "Cosmic Voyage", "The Dark Knight: Bonus Material", "Wish Wizard", "America Beyond the Color Line", "All About Us", "A Raisin in the Sun", "The Magic of Belle Isle", "Teachers", "Heart Stopper", "Attica", "Eyewitness", "The Art of Romare Bearden", "Death of a Prophet", "m.0h0_gsx", "m.0h0zs8c"]
where was barack hussein obama sr born?	["Honolulu"]	["Nyang\u2019oma Kogelo"]
where was martin luther king jr buried?	["Martin Luther King, Jr., National Historic Site"]	["Martin Luther King, Jr., National Historic Site"]
what type of cancer did eva peron have?	["Cervical cancer"]	["Cancer", "Cervical cancer"]
what type of drugs did whitney houston?	["Cocaine overdose"]	["Drowning", "Coronary artery disease", "Cocaine overdose"]
what country did gregor mendel live in?	["Brno", "Austrian Silesia"]	["Austria-Hungary"]
what city and state is yale located in?	["Connecticut"]	["Connecticut"]
where was martin luther king jr raised?	["Atlanta"]	["Atlanta"]
what schools did anders celsius attend?	["Uppsala University"]	["Uppsala University"]
what did shakespeare become famous for?	["Poet", "Playwright", "Dramatist", "Lyricist", "Author"]	["Actor", "Poet", "Author", "Lyricist", "Playwright", "Dramatist"]
what does george wilson do for a living?	["American football player"]	[]
where does archbishop desmond tutu live?	["South Africa"]	["South Africa"]
who was isaac newton and what did he do?	["Mathematician", "Physicist", "Philosopher", "Astronomer", "Scientist", "Chemist"]	["Chemist", "Physicist", "Scientist", "Mathematician", "Astronomer", "Philosopher"]
who did jennifer lawrence play in x men?	["Mystique"]	["Sam", "Marie Weinberg", "Katniss Everdeen", "Mystique", "Mariana", "Ree Dolly", "Elissa", "Zoe Hughes", "Norah", "Serena Pemberton", "Tiff", "Tiffany", "Frantic Girl", "Agnes", "Young Zoe", "Caitlin"]
what language do the maasai tribe speak?	["Maasai Language"]	["S. S. Ole Sankan"]
where did michelle obama graduated from?	["Harvard Law School", "Whitney M. Young Magnet High School", "Princeton University"]	["Harvard University", "Princeton University", "Harvard Law School", "Whitney M. Young Magnet High School"]
what schools did sir isaac newton go to?	["The King's School, Grantham", "Trinity College, Cambridge"]	["Trinity College, Cambridge", "The King's School, Grantham"]
what state is saint louis university in?	["Missouri"]	["Missouri"]
who does kellan lutz play in prom night?	["Mark Rider"]	["Rick Leland"]
what college did sir isaac newton go to?	["The King's School, Grantham", "Trinity College, Cambridge"]	["Trinity College, Cambridge", "The King's School, Grantham"]
which country was justin bieber born in?	["Canada"]	["London"]
where did they find jenni rivera's body?	["Iturbide, Nuevo Le\u00f3n"]	["California"]
who did carrie ann inaba get engaged to?	["Jesse Sloan"]	["Jesse Sloan"]
where do scottish people originate from?	["Celts", "Europeans"]	["United Kingdom"]
what high school did maya angelou go to?	["George Washington High School"]	["George Washington High School", "California Labor School"]
where did george w bush live as a child?	["New Haven"]	["Washington, D.C.", "Midland"]
who originally voiced meg on family guy?	["Mila Kunis"]	["Lacey Chabert", "Mila Kunis"]
where was george washington carver from?	["Diamond"]	["Diamond"]
what university did gordon brown attend?	["University of Edinburgh"]	["University of Edinburgh", "Kirkcaldy High School", "Kirkcaldy West Primary School"]
what were amelia earhart's achievements?	["Writer", "Pilot"]	["Writer", "Pilot"]
what country does rafael nadal play for?	["Spain"]	["Spain"]
what other movies is josh hutcherson in?	["The Hunger Games", "Bridge to Terabithia", "The Kids Are All Right"]	["The Kids Are All Right", "American Splendor", "Party Wagon", "RV", "Motocross Kids", "Cirque du Freak: The Vampire's Assistant", "Bridge to Terabithia", "Firehouse Dog", "Wilder Days", "Little Manhattan", "Journey 2: The Mysterious Island", "House Blend", "Journey to the Center of the Earth", "Kicking & Screaming", "Zathura", "The Hunger Games", "The Hunger Games: Catching Fire", "Miracle Dogs", "The Polar Express", "Detention", "Winged Creatures", "Red Dawn", "Epic", "The Forger", "One Last Ride", "The Third Rule", "7 Days in Havana"]
what is the new movie john carter about?	["Adventure film", "Science Fiction", "Action film", "Fantasy"]	["Taylor Kitsch"]
where did margaret hoover go to college?	["Davidson College"]	["Davidson College"]
what college did magic johnson play for?	["Michigan State University"]	["Michigan State University", "Everett High School"]
what school did douglas macarthur go to?	["TMI \u2014 The Episcopal School of Texas"]	["United States Military Academy", "TMI \u2014 The Episcopal School of Texas"]
what college did deion sanders jr go to?	["Florida State University"]	["Tulane University", "Washington and Lee University", "Louisiana State University", "Tulane University Law School"]
what is the name of king george vi wife?	["Queen Elizabeth The Queen Mother"]	["Queen Elizabeth The Queen Mother"]
who plays timon's voice in the lion king?	["Nathan Lane"]	["James Earl Jones", "Matthew Broderick", "Whoopi Goldberg", "Jim Cummings", "Robert Guillaume", "Nathan Lane", "Rowan Atkinson", "Jeremy Irons", "Jonathan Taylor Thomas", "Ernie Sabella", "Moira Kelly", "Cheech Marin", "Madge Sinclair", "Niketa Calame", "Zoe Leader"]
what kourtney kardashian boyfriends name?	["Scott Disick"]	["Penelope Scotland Disick", "Mason Dash Disick"]
where is the main headquarters of google?	["California"]	["California"]
where did martin luther king got shot at?	["Memphis"]	["Memphis"]
who did reese witherspoon get married to?	["Ryan Phillippe"]	["Ryan Phillippe", "Jim Toth"]
who did johnny depp play in corpse bride?	["Victor Van Dort"]	["Victor Van Dort"]
where did the iroquois indians come from?	["Qu\u00e9bec"]	["Ontario", "Qu\u00e9bec"]
what movies has liam hemsworth played in?	["Knowing", "Triangle", "The Hunger Games", "The Expendables 2", "The Last Song", "Timeless", "Empire State", "The Hunger Games: Catching Fire", "Arabian Nights", "Love and Honor"]	["The Expendables 2", "Triangle", "The Last Song", "The Hunger Games", "The Hunger Games: Catching Fire", "Knowing", "Love and Honor", "Empire State", "Arabian Nights", "Paranoia", "Timeless", "Aurora Rising"]
which countries speak germanic languages?	["Icelanders", "Dutch people", "Austrians", "Faroese people", "Danes", "Flemish people", "Frisians", "Swedes", "Germans", "English people"]	["Old Gutnish", "Cimbrian language", "Bavarian Language", "Hamburgisch dialect", "Brandenburgisch dialect", "Eastphalian dialect", "German, Hutterite Language", "Pennsylvania German language", "Plautdietsch Language", "German, Colonia Tovar Language", "Westphalian language", "Swabian German", "Silesian, Lower Language", "Middle Dutch", "Middle High German", "Early New High German", "Middle Low German", "Alemannic German", "Palatine German language", "Old High German", "Central Franconian dialects", "Hunsr\u00fcckisch dialect", "Dutch Language", "K\u00f6lsch Language", "Basel German", "Saterland Frisian language", "Frisian languages", "West Flemish", "Walser German", "Vilamovian language", "Old Saxon", "Forth and Bargy dialect", "German Language", "Flemish language", "West Low German", "Frankish Language", "Luxembourgish language", "Old English", "Bernese German", "Hollandic", "Brabantian dialect", "East Flemish", "Zurich German", "Low Prussian dialect", "Hessian dialects", "Highest Alemannic German", "High Alemannic German", "Low Alemannic German", "Saxon, Upper Language", "Swiss German Language", "Rhine Franconian dialects", "Yiddish Language", "Berlin Brandenburgish dialects", "East Central German", "French Flemish", "Aachen dialect", "Middle English", "Old Dutch", "Scots Language", "Alsatian language", "Afrikaans Language", "Danish Language", "Norwegian Language", "Swedish Language", "Gothic Language", "Old Norse", "Icelandic Language", "Norn Language", "Lombardic language", "Crimean Gothic", "Elfdalian", "Faroese", "Vandalic language", "Burgundian language"]
where did buster posey go to high school?	["Leesburg"]	["Florida State University"]
what kind of cancer did carl wilson have?	["Lung cancer"]	["Lung cancer", "Brain tumor"]
what university did obama graduated from?	["Columbia University"]	["Columbia University", "Occidental College", "Punahou School", "Harvard Law School", "State Elementary School Menteng 01", "Noelani Elementary School", "St. Francis of Assisi Catholic School"]
where did scott fitzgerald go to college?	["Princeton University"]	["Princeton University", "St. Paul Academy and Summit School", "Nardin Academy"]
what school did ben roethlisberger go to?	["Miami University"]	["Miami University"]
what did franz liszt do to earn a living?	["Priest", "Pianist", "Composer", "Virtuoso"]	["Composer", "Pianist", "Priest", "Virtuoso"]
what was laura ingalls wilder famous for?	["Writer", "Author"]	["Writer", "Author"]
who did benjamin franklin get married to?	["Deborah Read"]	["Deborah Read"]
what university did romney graduated from?	["Stanford University", "Cranbrook Schools", "Harvard Law School", "Harvard Business School", "Harvard University", "Brigham Young University"]	["Harvard University", "Stanford University", "Brigham Young University", "Harvard Business School", "Harvard Law School", "Cranbrook Schools"]
what disease did patrick swayze died from?	["Pancreatic cancer"]	["Pancreatic cancer"]
what country sponsored ferdinand magellan?	["Portugal"]	["Portugal", "Kingdom of Portugal"]
what is the name of sonia gandhi daughter?	["Priyanka Vadra"]	["Priyanka Vadra", "Rahul Gandhi"]
what other movies has tom hardy played in?	["Warrior", "Mad Max: Fury Road", "Thick as Thieves", "Lawless", "This Means War", "Tinker, Tailor, Soldier, Spy", "Bronson", "The Dark Knight Rises", "Inception", "Sergeant Slaughter, My Big Brother"]	["Everest", "Lethal Dose", "Sweeney Todd", "Inception", "dot the i", "Black Hawk Down", "The Dark Knight Rises", "Minotaur", "Wuthering Heights", "Lawless", "Tinker, Tailor, Soldier, Spy", "Perfect", "Thick as Thieves", "Bronson", "Warrior", "Marie Antoinette", "This Means War", "The Reckoning", "Sucker Punch", "Star Trek Nemesis", "RocknRolla", "Flood", "Scenes of a Sexual Nature", "W\u0394Z", "Child 44", "Layer Cake", "The Inheritance", "Sergeant Slaughter, My Big Brother", "Deserter", "The Virgin Queen", "Mad Max: Fury Road", "Colditz", "Gideon's Daughter", "EMR", "Locke", "Splinter Cell", "Animal Rescue", "The Outsider"]
where was john f kennedy when he got shot?	["Dallas"]	["Dallas"]
what school did john henry thompson go to?	["Victoria University of Manchester", "University of Manchester", "University of Cambridge"]	["University of London"]
what type of cancer did larry hagman have?	["Head and neck cancer", "Cancer", "Leukemia"]	["Cancer", "Leukemia", "Head and neck cancer"]
where did robert kardashian go to college?	["University of San Diego", "University of San Diego School of Law", "University of Southern California"]	["University of San Diego", "University of Southern California", "University of San Diego School of Law"]
what language did the sioux indians speak?	["Sioux language", "French Language", "English Language"]	["English Language", "French Language", "Sioux language"]
where is the ellen degenerous show filmed?	["Beverly Hills"]	["My Short Film"]
what part did jeff conaway play in grease?	["Kenickie Murdoch"]	["Kenickie Murdoch"]
what else has jennifer lawrence played in?	["The Poker House", "The Hunger Games", "Garden Party", "The Burning Plain", "Like Crazy", "Winter\u2019s Bone", "The Beaver", "X-Men: First Class", "Devil You Know", "House at the End of the Street"]	["The Poker House", "Garden Party", "Winter\u2019s Bone", "X-Men: First Class", "The Hunger Games", "The Hunger Games: Catching Fire", "Devil You Know", "Silver Linings Playbook", "The Beaver", "House at the End of the Street", "X-Men: Days of Future Past", "Serena", "Like Crazy", "The Burning Plain", "Company Town", "American Hustle", "Not Another High School Show"]
who does chris hemsworth have a baby with?	["Elsa Pataky"]	["Elsa Pataky"]
what movies have robert pattinson in them?	["Eclipse", "Dark Kingdom: The Dragon King", "New Moon", "Remember Me", "How to Be", "Harry Potter and the Order of the Phoenix", "Little Ashes", "Bel Ami", "Twilight", "The Twilight Saga: Breaking Dawn - Part 1"]	["Eclipse", "New Moon", "Twilight", "Remember Me", "The Twilight Saga: Breaking Dawn - Part 1", "The Twilight Saga: Breaking Dawn - Part 2"]
what was the cause of death for bruce lee?	["Cerebral edema"]	["Cerebral edema"]
where did mitt romney's parents come from?	["Bloomfield Hills"]	["United States of America"]
where did aaron rodgers go to high school?	["Pleasant Valley High School"]	["University of California, Berkeley", "Butte College", "Pleasant Valley High School"]
what country does justin bieber come from?	["Canada"]	["Canada"]
who plays anakin skywalker in star wars 1?	["Jake Lloyd"]	["Jake Lloyd"]
who plays robin hood in prince of thieves?	["Kevin Costner"]	["Kevin Costner"]
what business did andrew carnegie dominate?	["U.S. Steel"]	["Businessperson", "Entrepreneur", "Business magnate"]
where did rick santorum attend high school?	["Carmel High School"]	["University of Pittsburgh", "Pennsylvania State University", "Penn State University, Dickinson School of Law", "Carmel High School"]
what other movies has ryan gosling been in?	["The United States of Leland", "Half Nelson", "The Slaughter Rule", "Stay", "Lars and the Real Girl", "The Believer", "Fracture", "Murder by Numbers", "The Notebook", "All Good Things"]	["Fracture", "Lars and the Real Girl", "Crazy, Stupid, Love.", "Only God Forgives", "Remember the Titans", "The Believer", "The Notebook", "Nothing Too Good for a Cowboy", "Blue Valentine", "Stay", "Drive", "The Ides of March", "The Place Beyond the Pines", "All Good Things", "Murder by Numbers", "Gangster Squad", "Half Nelson", "I'm Still Here: Real Diaries of Young People Who Lived During the Holocaust", "The Slaughter Rule", "The United States of Leland", "Lawless", "Logan's Run", "Untitled Terrence Malick project", "Drunk History Christmas"]
where did charles darwin and his wife live?	["Downe, Kent", "England", "London", "Shrewsbury"]	["England", "London", "Shrewsbury", "Downe, Kent"]
where was jesus after he died on the cross?	["Church of the Holy Sepulchre"]	["Calvary"]
what was the name of henry viii first wife?	["Catherine of Aragon"]	["Catherine Parr", "Anne of Cleves", "Catherine of Aragon", "Jane Seymour", "Anne Boleyn", "Catherine Howard"]
what did stephen hawking become famous for?	["Author", "Mathematician", "Professor", "Writer", "Cosmologist", "Physicist", "Actor", "Astronomer", "Scientist", "Science writer"]	["Professor", "Actor", "Physicist", "Scientist", "Writer", "Author", "Science writer", "Mathematician", "Astronomer", "Cosmologist"]
where did benjamin franklin went to school?	["Boston Latin School"]	["Boston Latin School"]
where did abraham and his descendants live?	["Canaan"]	["Canaan"]
what type of cancer did eva peron die from?	["Cervical cancer"]	["Cancer", "Cervical cancer"]
where do most of the people live in russia?	["Moscow"]	["Sam Levene", "Vladimir Bogomolov", "Samuel Hoffenstein", "Yelena Tregubova", "Nosson Tzvi Finkel", "Aleksandr Salugin", "Magomed Abdusalamov", "Vladimir Khozin", "Nikolai Zabolotny", "Kid Kaplan", "Sergei Zadelenov", "Irina Tweedie", "Bula Liebling", "Peter von Buxhoeveden", "Vladimir Kiselev", "Princess Natalia Konstantinovna of Russia", "Rustem Khuzin", "Joseph Neistat", "Jennie Sherman", "Ida Kitaeva Raphael", "David Hoffman", "Paul Baratoff", "Leo Mostovoy", "Billy West", "Daria Badanina", "Dina Smirnova", "Jeanne Gerson", "Anatol Winogradoff", "Nikolay Ivanovich Fedorov", "Eduard von Keyserling", "Gregory P. Tschebotarioff", "Natalia Vorobieva", "Ella Pamfilova", "Bar Paly", "Aleksandr Yeliseyev", "Eugene Izotov", "Anastasiya Voznesenskaya", "Patriarch Nikon", "Tikhon Nikolaevich", "Guri Nikolaevich", "Sergey Dvoryankov", "Pyotr Pavlovich Yershov", "Pelageya Polubarinova-Kochina", "Pati Behrs", "Sam Finn", "Sergei Filatov", "Valery Shantsev", "Anatoly Kvashnin", "Eugene Podkletnov", "Anna Altman", "Esther Hochfeld", "Jacob Bernstein", "Fannie Rosen", "Beckie Kessler", "Abraham Binowitz", "Yetta Goldstein", "Ida Brodsky", "Sarah Brodsky", "Dora Evans", "Max Florin", "Tsarevna Feodosia Feodorovna of Russia", "Pat Goldin", "Sergei Tarakanov", "Sergey Alexandrovich Pavlov", "Sergei Kruglov", "Alena Khomich", "Alexandra Kapustina", "Ekaterina Lebedeva", "Ivan Usenko", "Svetlana Terenteva", "Leonid Mikhailovich Kharitonov", "Avvakum", "Aleksey Lebed", "Artem Gordeyev", "Semyon Shchedrin", "Abraham Rosenson", "Olga Nikolaeva", "Sergey Nikitin", "Alexander Kalyagin", "Joel Bolomboy", "Rick Vallin", "Maksim Vladimirovich Andreyev", "Sergei Jordonov", "Nina Evteeva", "Leopold Albertson", "Lyubov Tolkalina", "Kamaliya", "Valery Leontiev", "Sophie Tucker", "Aleksandr Benyaminov", "\u0422\u0430\u0442\u044c\u044f\u043d\u0430 \u041d\u0438\u043a\u043e\u043b\u0430\u0435\u0432\u0430", "Anton Zaslavski", "Benjamin Margolin", "Albert Makashov", "Ekaterina Kramarenko", "Michael Roiz", "Yuri Gidzenko", "Max Lerner", "Alexander Peters", "Harry Diamond", "Marina Karaseva", "Max Bollinger", "Boris St\u00fcrmer", "Oleg Bogayev", "Mois\u00e9s Arias", "Alexei Nemov", "Eugene Mirman", "Nikolay Morilov", "Artyom Leonov", "Nikolai Lebedev", "Nikolai Demidenko", "Vera de Bosset", "Vitaly Kravchenko", "Dmitry Lipkin", "Sergey Gerasimovich Mitin", "Aleksandr Petrov", "Evgeni Tomov", "Sergei Kozlovsky", "Nikolai Ruzsky", "Ilona Andrews", "Larisa Migachyov", "Mikhail Biryukov", "Yulia Lozhechko", "Dan Milner", "Katie Goodman", "Joseph Goodman", "Julia Rosen", "Elvira Bolgova", "Vasili Domrachyov", "Valery Zorkin", "Vladimir Kashpur", "Vyacheslav Baranov", "Ivan Lopatin", "Ivan Khrutsky", "Ruslan Pashtov", "Yana Gorskaya", "Alexander Anisimov", "Alexey Alexandrov", "Mikhail Krotov", "Pavel Krasheninnikov", "Vladimir Kolesnikov", "Konstantin Chuychenko", "Siegfried Enns", "Mikhail Vartanov", "Olga Rodionova", "Pyotr Mamonov", "Alexander Gorchilin", "Michael Morris", "Hermogenes of Moscow", "Evgenia Linetskaya", "Yuri Titov", "Moshe Menuhin", "Eugene Alper", "Sergey Reformatsky", "Ivan Panin", "Barbara Karinska", "Ilya Musin", "Anri Khagba", "Louiza Podimata", "Margarita Krinitsyna", "Wiera Gran", "Nikita Shabalkin", "Pyotr Semyonovich Popov", "Shirvani Muradov", "Natalia Goncharova", "Nadezhda Kosintseva", "Alexander Alexandrovich Morozov", "Harry Sauber", "Sonya Levien", "Andrei Vasyanovich", "Sergey Tchepikov", "Murray Spivack", "Francisco Infante-Arana", "Andrey Tokarev", "Olga Sharutenko", "Aleksandr Kosarev", "Mikhail Nikolayevich Solovyov", "Anna Demidova", "Aleksei Savelyev", "Vasili Pavlov", "Aslan Dudiyev", "William Barrymore", "Artush Galstyan", "Sergey Ivanovich Vavilov", "Nina Vanna", "Nikolai Parfyonov", "Yuri Stepanov", "Evgeniy Gabrilovich", "J\u00f3zef Wysocki", "Alexander Vasiliev", "Ella Krasner", "Pavel Tregubov", "Lev Sverdlin", "Andrey Bukhlitskiy", "Artyom Molodtsov", "Sergei Revyakin", "Ida Pearl", "Anatole Abragam", "Mikhail Zagoskin", "Modest Ilyich Tchaikovsky", "Natalya Lisovskaya", "Georges Gurvitch", "Sam Marcy", "Ngawang Wangyal", "Valentina Zimina", "Louis Fogel", "Aleksandr Kvyatkovsky", "Patriarch Joseph", "Vitali Vashedsky", "Natalia Molchanova", "Louis Stevens", "Ivan Ives", "Gennadiy Chernovol", "Bert Shefter", "David Chudnow", "Josef Myrow", "Lina Makhuli", "Pavel Kalachkine", "Ekaterina Galkina", "Margarita Fomina", "Yuri Morozov", "Denis Kirilenko", "Ludmila Privivkova", "Yury Osipov", "Yevgeni Trefilov", "Pavel Sukosyan", "Regina  Rakhimova", "J.G. Bachmann", "Louis Burstein", "Lili Dehn", "Leo Wiener", "Olga Generalova", "Evgeni Utkin", "Sizan De Asies Ronaldo", "Herman Schlom", "Nike Borzov", "Polina Kouklina", "Sergei Petrov", "Sofka Skipwith", "George Joseph Winner", "Elena Leonova", "Jerry Bergen", "Eugene Sigaloff", "Viacheslav Denysov", "Roman Petushkov", "Soslan Tigiev", "Yevgeny Nazdratenko", "Viktor Astafiyev", "Paul Guertzman", "Eduard Sukhanov", "Vladimir Bekhterev", "Anna Ulyanova", "Ibragim Tsallagov", "Anastasia Abramova", "Igor Youskevitch", "Constantin von Monakow", "Valentina Popova", "Anna Terekhova", "Lyubov Kharlamova", "Ralph Zondag", "Adam Rom", "Ilya Mikhalchuk", "Jennie Simon", "Jimmy Rosen", "Ilya Abayev", "Rasim Tagirbekov", "Vasily Agapkin", "Ava Rose Williams", "Oleg Kuvaev", "Aleksei Sapogov", "Vera Markovna Orlova", "Arkadi Trusov", "Grisha Maslov", "Alexander Legkov", "Ivan Babikov", "Maxim Vylegzhanin", "Alexey Petukhov", "Aleksejus Novoselskis", "Sergey Mikayelyan", "Ekaterina Chuikova", "Yevgeniya Medvedeva", "Natalya Korostelyova", "Boris Vermont", "Victor Merinow", "Zulya Kamalova", "Lyubov Popova", "Murder of Anna Svidersky", "Otto Mears", "Mintimer Shaimiev", "Aleksandra Pasynkova", "Anna Arkhipova", "Maria Kalmykova", "Farid Mukhametshin", "Anatoli Panfilov", "Sergey Pugachyov", "Leon Mirsky", "Ramil Sabitov", "Harold Lipstein", "Alexander Carr", "Marat Kulakhmetov"]
who played captain kirk in star trek movie?	["William Shatner"]	["Chris Pine", "Jimmy Bennett"]
how old is bruno mars and where is he from?	["Honolulu"]	["Honolulu"]
where did tennessee williams go to college?	["Washington University in St. Louis", "University of Missouri\u2013Columbia", "University of Iowa", "The New School"]	["University of Missouri\u2013Columbia", "University of Iowa", "Washington University in St. Louis", "The New School"]
where was country singer george jones born?	["Saratoga"]	["Saratoga"]
what type of cancer did gilda radner die of?	["Ovarian cancer"]	["Ovarian cancer"]
who plays the voice of kitt in knight rider?	["William Daniels"]	["K.I.T.T."]
what did george washington do as a teenager?	["Surveyor"]	["Engineer", "Politician", "Military Officer", "Farmer", "Soldier", "Surveyor"]
what basketball player is married to monica?	["Shannon Brown"]	["Shannon Brown"]
who plays mary jane in the spiderman movies?	["Sara Ballantine", "Kirsten Dunst"]	["Tobey Maguire", "Christopher Daniel Barnes", "Andrew Garfield", "Dan Poole", "Max Charles"]
what school did sir ernest rutherford go to?	["Trinity College, Cambridge", "Nelson College", "University of Canterbury", "University of Cambridge", "University of New Zealand"]	["University of Cambridge", "Trinity College, Cambridge", "University of Canterbury", "University of New Zealand", "Nelson College"]
what movies did christopher plummer play in?	["The Girl with the Dragon Tattoo", "Gandahar", "My Dog Tulip", "Up", "The Imaginarium of Dr. Parnassus", "Beginners", "Priest", "Five Good Years", "9", "The Last Station"]	["Malcolm X", "The First Circle", "Wolf", "Full Disclosure", "The Boy in Blue", "Barrymore", "Impolite", "The Conspiracy of Fear", "Highpoint", "Shadow Dancing", "Four Minutes", "The Lake House", "The Insider", "Inside Daisy Clover", "Blackheart", "The Night of the Generals", "Possessed", "Starcrash", "A Beautiful Mind", "Beginners", "The Royal Hunt of the Sun", "Ararat", "The Amateur", "Must Love Dogs", "Star Trek VI: The Undiscovered Country", "Up", "The Clown at Midnight", "Nicholas Nickleby", "National Treasure", "Somewhere in Time", "My Dog Tulip", "Conduct Unbecoming", "Aces High", "Hanover Street", "Already Dead", "An American Tail", "The Pyx", "Rumpelstiltskin", "Stage Struck", "The Man Who Planted Trees", "American Tragedy", "Our Fathers", "Babes in Toyland", "Gospel of John", "Murder by Decree", "The Man Who Would Be King", "Vampire in Venice", "The Girl with the Dragon Tattoo", "Closing the Ring", "Blizzard", "Alexander", "Cold Creek Manor", "The Boss' Wife", "The Return of the Pink Panther", "Inside Man", "The Imaginarium of Dr. Parnassus", "The Last Station", "The New World", "Priest", "Syriana", "Where the Heart Is", "Man in the Chair", "Hamlet at Elsinore", "Firehead", "9", "Lucky Break", "Emotional Arithmetic", "Prototype", "The Assignment", "Skeletons", "Harrison Bergeron", "Battle of Britain", "Secrets", "Night Flight", "Madeline: Lost in Paris", "Money", "International Velvet", "The Tempest", "Nobody Runs Forever", "Hidden Agenda", "Winchell", "Five Good Years", "Dolores Claiborne", "The Fall of the Roman Empire", "When the Circus Came to Town", "The Sound of Music", "Dreamscape", "12 Monkeys", "The Dinosaur Hunter", "The Scarlet and the Black", "A Hazard of Hearts", "Young Catherine", "Dark Descent of the Forgotten Empress", "A Marriage: Georgia O'Keeffe and Alfred Stieglitz", "Ordeal by Innocence", "The Spiral Staircase", "On Golden Pond", "Lily in Love", "Heidi", "The Silent Partner", "Dracula 2000", "The Day That Shook the World", "Wind Across the Everglades", "Liar's Edge", "Gandahar", "Rock-a-Doodle", "Waterloo", "Dragnet", "Kali, the Little Vampire", "Souvenir", "Eyewitness", "Triple Cross", "Silver Blaze"]
where did theodor schwann get his education?	["Humboldt University of Berlin"]	["Humboldt University of Berlin", "University of Bonn", "University of W\u00fcrzburg"]
where is the main branch of bank of america?	["Charlotte"]	["Charlotte"]
what was the last movie sean connery was in?	["Sir Billi"]	["The Rock", "The Hunt for Red October", "The Name of the Rose", "Entrapment", "Finding Forrester", "Indiana Jones and the Last Crusade", "The Avengers", "The Untouchables", "Art"]
who is the mother of prince michael jackson?	["Katherine Jackson", "Joseph Jackson"]	["Katherine Jackson", "Joseph Jackson"]
what was the name of benjamin franklin wife?	["Deborah Read"]	["Deborah Read"]
what are the names of michael jackson's kids?	["Paris-Michael Katherine Jackson"]	["Prince Michael Jackson II", "Paris-Michael Katherine Jackson", "Michael Joseph Jackson, Jr."]
what role did george lucas play in star wars?	["Film Director"]	["Baron Papanoida", "Man Kissing on Bridge", "Missionary", "Alien on TV Monitor", "Disappointed Man"]
what was the cause of death for huell howser?	["Prostate cancer"]	["Prostate cancer"]
where is the headquarters of bank of america?	["Charlotte"]	["Charlotte"]
what college did martin luther king jr go to?	["Morehouse College"]	["Boston University", "Washington High School", "Morehouse College", "Crozer Theological Seminary"]
what part did winona ryder play in star trek?	["Amanda Grayson"]	["Amanda Grayson"]
what kind of cancer did farrah fawcett die of?	["Anal cancer"]	["Anal cancer"]
who plays stephanie plum in one for the money?	["Katherine Heigl"]	["Katherine Heigl"]
what was the cause of death for laci peterson?	["Murder"]	["Murder"]
where did rudolf virchow conduct his research?	["Humboldt University of Berlin", "University of W\u00fcrzburg"]	["Humboldt University of Berlin", "University of W\u00fcrzburg"]
what kind of leukemia did jill clayburgh have?	["B-cell chronic lymphocytic leukemia"]	["Leukemia", "B-cell chronic lymphocytic leukemia"]
who was sir walter raleigh and what did he do?	["Poet", "Courtier", "Sailor", "Writer", "Soldier"]	["Poet", "Writer", "Sailor", "Soldier", "Courtier"]
who does the voice for chucky in child's play?	["Brad Dourif"]	["Brad Dourif", "Edan Gross", "John Franklin"]
where are yamaha outboard motors manufactured?	["Shizuoka Prefecture"]	[]
who is the voice of eric cartman on south park?	["Trey Parker"]	["Trey Parker"]
what was the ancient egyptians spoken language?	["Egyptian Arabic"]	["Egyptian Arabic", "Egyptian language", "Coptic Language", "Sa'idi Arabic", "Languages of Egypt"]
what nationality is taylor lautner jacob black?	["United States of America"]	["United States of America"]
who played bilbo in the fellowship of the ring?	["Ian Holm"]	["Ian Holm"]
how many kids were there in the kennedy family?	["Robert F. Kennedy", "Ted Kennedy", "Rosemary Kennedy", "Kathleen Cavendish", "Patricia Kennedy Lawford", "Jean Kennedy Smith", "Eunice Kennedy Shriver", "Joseph P. Kennedy, Jr."]	["1"]
what boarding school did mark zuckerberg go to?	["Phillips Exeter Academy"]	["Harvard University", "Phillips Exeter Academy", "Ardsley High School", "Mercy College"]
what concentration camp did anne frank died in?	["Bergen-Belsen concentration camp"]	["Bergen-Belsen concentration camp"]
where did drew brees go to college wikianswers?	["Purdue University"]	["Purdue University", "Stanford Graduate School of Business", "Westlake High School"]
what city is the university of oregon state in?	["Eugene"]	["Oregon"]
what is samuel langhorne clemens well known for?	["Lecturer", "Author", "Writer", "Journalist", "Novelist", "Humorist"]	["Novelist", "Writer", "Journalist", "Author", "Lecturer", "Humorist"]
where is harley davidson corporate headquarters?	["Milwaukee"]	["Milwaukee"]
who does donnie wahlberg play in the sixth sense?	["Vincent Grey"]	["Vincent Grey"]
what are all the movies taylor swift has been in?	["Hannah Montana: The Movie", "Campfire Stories;Comes Around Gos Around", "The Lorax", "Valentine's Day"]	["Speak Now", "Safe & Sound", "Fearless", "Valentine's Day", "Red", "You Belong with Me", "Mean", "We Are Never Ever Getting Back Together", "White Horse", "White Horse", "Mean", "You Belong With Me"]
what did james k polk do before he was president?	["Lawyer"]	["Lawyer", "Politician", "Farmer"]
what town was martin luther king assassinated in?	["Memphis"]	["Atlanta"]
where did george washington carver go to collage?	["Tuskegee University", "Iowa State University", "Simpson College"]	["Iowa State University", "Tuskegee University", "Simpson College"]
what school did michael jackson go to high school?	["Montclair College Preparatory School"]	["Montclair College Preparatory School"]
what is the most populated state in united states?	["California"]	["California", "Idaho", "Illinois", "Kentucky", "Louisiana", "Mississippi", "Missouri", "Minnesota", "Maine", "New Hampshire", "New York", "North Dakota", "Pennsylvania", "South Carolina", "Texas", "Utah", "Virginia", "West Virginia", "Washington", "Wisconsin", "Wyoming", "Georgia", "Connecticut", "Nebraska", "Rhode Island", "South Dakota", "Alabama", "Colorado", "Delaware", "Florida", "Iowa", "Indiana", "Kansas", "Maryland", "Michigan", "Montana", "New Mexico", "North Carolina", "Massachusetts", "Oregon", "Ohio", "Tennessee", "Alaska", "Arizona", "New Jersey", "Arkansas", "Hawaii", "Nevada", "Oklahoma", "Vermont"]
who did viggo mortensen play in lord of the rings?	["Aragorn"]	["Clay", "Carl Frazer", "Sigmund Freud", "Walker Jerome", "Wes", "Cameron Dove", "William S. Burroughs", "Jimmy Kowalski", "Phillip", "Nikolai", "Burke/Forsythe Electrocution", "Lucifer", "Juanito", "John W. Poe", "Everett Hitch", "Old Bull Lee", "John Halder", "Aragorn", "Eddie Boone", "David Shaw", "Tom Stall", "Frank Roberts", "Pedro", "Eddie 'Tex' Sawyer", "Guy Foucard", "David Brandt", "Sam Loomis", "Ronnie", "Frank Hopkins", "Henry Clemens", "Lt. Peter 'Weps' Ince", "Master Chief John James Urgayle", "Chester MacFarland", "Roy Nord", "Nick Davis", "John E. 'Johnny' Faro", "Diego Alatriste", "Hans", "Lieutenant at LeBoeuf", "Lalin", "Jerome Stample", "Agust\u00edn", "Man", "Caspar Goodwood", "Moses Hochleitner", "Green"]
where did george herbert walker bush go to college?	["Yale University", "Phillips Academy", "Davenport College"]	["Yale University", "Phillips Academy", "Davenport College"]
where was the first microsoft headquarters located?	["Redmond"]	["Redmond"]
what are the names of michael jackson's 3 children?	["Paris-Michael Katherine Jackson", "Prince Michael Jackson I", "Prince Michael Jackson II"]	["Prince Michael Jackson II", "Paris-Michael Katherine Jackson", "Michael Joseph Jackson, Jr."]
what character did billy d williams play in star wars?	["Lando Calrissian"]	["Black holes", "Realms of Emerging Light", "Black Holes"]
what did neil armstrong say when he landed on the moon?	["That's one small step for man, one giant leap for mankind."]	["That's one small step for man, one giant leap for mankind."]
what did thomas jefferson do before he became president?	["Statesman", "Author", "Writer", "Philosopher", "Architect", "Lawyer", "Farmer", "Archaeologist", "Teacher", "Inventor"]	["Inventor", "Lawyer", "Writer", "Author", "Architect", "Teacher", "Philosopher", "Farmer", "Archaeologist", "Statesman"]
who played darth vader at the end of return of the jedi?	["James Earl Jones"]	["James Earl Jones", "David Prowse", "Sebastian Shaw"]
who voiced darth vader in the original star wars movies?	["James Earl Jones"]	["James Earl Jones", "Jake Lloyd", "David Prowse", "Sebastian Shaw", "Hayden Christensen", "Matt Lanter", "Robert E. Bean"]
with which ancient ruler did julius caesar fall in love?	["Cornelia Cinna minor", "Pompeia", "Calpurnia Pisonis"]	["Pompeia", "Cornelia Cinna minor", "Calpurnia Pisonis"]
what school did martin luther king jr received his doctorate degree from?	["Boston University"]	["Boston University", "Washington High School", "Morehouse College", "Crozer Theological Seminary"]
